{
  "largeur": 29,
  "hauteur": 32,
  "chipset": "HunterArene.png",
  "musique": "hunter.ogg",
  "couche0": [
    [ 226,  228,  228,  386,  228,  228,  228,  228,  228,  386,  228,  228,  228,  350,  351,  352,  228,  228,  228,  386,  228,  228,  228,  228,  228,  122,  122,  228,  229],
    [ 256,  258,  258,  416,  258,  258,  258,  258,  258,  416,  258,  258,  258,  380,  381,  382,  258,  258,  258,  416,  258,  258,  258,  258,  258,  152,  152,  258,  259],
    [ 286,  288,  288,  288,  288,  288,  288,  288,  288,  288,  288,  288,  288,  410,  411,  412,  288,  288,  288,  288,  288,  288,  288,  288,  288,  182,  182,  288,  289],
    [ 366,  366,    4,    5,    6,  366,  366,  366,    4,    5,    6,  366,  366,  262,  263,  319,  366,  366,    4,    5,    6,  366,  366,  366,  366,  366,  366,  366,  366],
    [ 366,  366,   34,   35,   36,  366,  366,  366,   34,   35,   36,  366,  366,  292,  293,  349,  366,  366,   34,   35,   36,  366,  366,  366,  366,  366,   63,   63,  366],
    [ 254,  255,  366,  366,  366,  366,  366,  366,  366,  366,  366,  366,  366,  366,  366,  366,  366,  366,  366,  366,  366,  366,  366,  366,  366,  366,   63,  314,  315],
    [ 284,  285,  366,  366,  366,  366,  366,  366,  366,  366,  366,  366,  366,  366,  366,  366,  366,  366,  366,  366,  366,  366,  366,  366,  366,  366,   61,  344,  345],
    [ 366,  366,  366,  366,  366,  366,  366,  366,  366,  366,  366,  366,  366,  366,  366,  366,  366,  366,  366,  366,  366,  366,  366,  366,  366,  366,  366,   63,  366],
    [ 366,  366,  366,  366,  366,  196,  260,  261,  260,  261,  260,  261,  260,  261,  260,  261,  260,  261,  260,  261,  260,  261,  260,  198,  366,  366,  366,  366,  366],
    [ 366,  366,  366,  366,  366,  166,  230,  231,  230,  231,  230,  231,  230,  231,  230,  231,  230,  231,  230,  231,  230,  231,  230,  168,  366,  366,  366,  366,  366],
    [ 366,  366,  366,  366,  366,  196,  260,  261,  260,  261,  260,  261,  260,  261,  260,  261,  260,  261,  260,  261,  260,  261,  260,  198,  366,  366,  366,  366,  336],
    [ 366,  366,  366,  366,  366,  166,  230,  231,  230,  231,  230,  231,  230,  231,  230,  231,  230,  231,  230,  231,  230,  231,  230,  168,  366,   63,   63,  366,  366],
    [ 366,  366,  366,  366,  366,  196,  260,  261,  260,  261,  260,  261,  260,  261,  260,  261,  260,  261,  260,  261,  260,  261,  260,  198,  366,  366,   63,  366,  366],
    [ 366,  366,  366,  366,  366,  166,  230,  231,  230,  231,  230,  231,  230,  231,  230,  231,  230,  231,  230,  231,  230,  231,  230,  168,  366,  366,   63,  366,  366],
    [ 254,  255,  366,  366,  366,  196,  260,  261,  260,  261,  260,  261,  260,  261,  260,  261,  260,  261,  260,  261,  260,  261,  260,  198,  366,  366,   63,  314,  315],
    [ 222,  285,  366,  366,  366,  166,  230,  231,  230,  231,  230,  231,  230,  231,  230,  231,  230,  231,  230,  231,  230,  231,  230,  168,  366,  366,   63,  344,  339],
    [ 252,  253,  366,  366,  366,  196,  260,  261,  260,  261,  260,  261,  260,  261,  260,  261,  260,  261,  260,  261,  260,  261,  260,  198,  366,  366,  366,  368,  369],
    [ 282,  283,  366,  366,  366,  166,  230,  231,  230,  231,  230,  231,  230,  231,  230,  231,  230,  231,  230,  231,  230,  231,  230,  168,  366,  366,  366,  398,  399],
    [ 312,  313,  366,  366,  366,  196,  260,  261,  260,  261,  260,  261,  260,  261,  260,  261,  260,  261,  260,  261,  260,  261,  260,  198,  366,  366,  366,  428,  429],
    [ 342,  255,  366,  366,  366,  166,  230,  231,  230,  231,  230,  231,  230,  231,  230,  231,  230,  231,  230,  231,  230,  231,  230,  168,  366,  366,   63,  314,  459],
    [ 284,  285,  366,  366,  366,  196,  260,  261,  260,  261,  260,  261,  260,  261,  260,  261,  260,  261,  260,  261,  260,  261,  260,  198,  366,  366,   63,  344,  345],
    [ 366,  366,  366,  366,  366,  166,  230,  231,  230,  231,  230,  231,  230,  231,  230,  231,  230,  231,  230,  231,  230,  231,  230,  168,  366,  366,  366,  366,  366],
    [ 366,  366,  366,  366,  366,  196,  260,  261,  260,  261,  260,  261,  260,  261,  260,  261,  260,  261,  260,  261,  260,  261,  260,  198,  366,  366,  366,  366,  366],
    [ 366,  366,  366,  366,  366,  166,  230,  231,  230,  231,  230,  231,  230,  231,  230,  231,  230,  231,  230,  231,  230,  231,  230,  168,  366,  366,  366,  366,  366],
    [ 366,  366,  366,  366,  366,  196,  260,  261,  260,  261,  260,  261,  260,  261,  260,  261,  260,  261,  260,  261,  260,  261,  260,  198,  366,  366,  366,  366,  366],
    [ 366,  366,  366,  366,  366,  166,  230,  231,  230,  231,  230,  231,  230,  231,  230,  231,  230,  231,  230,  231,  230,  231,  230,  168,  366,  366,  366,  366,  366],
    [ 366,  366,  366,  366,  366,  196,  260,  261,  260,  261,  260,  261,  260,  261,  260,  261,  260,  261,  260,  261,  260,  261,  260,  198,  366,  366,  366,  366,  366],
    [ 254,  255,  366,  366,  366,  166,  230,  231,  230,  231,  230,  231,  230,  231,  230,  231,  230,  231,  230,  231,  230,  231,  230,  168,  366,  366,  366,  314,  315],
    [ 284,  285,  366,  366,  366,  366,  366,  366,  366,  366,  366,  366,  366,  366,  366,  366,  366,  366,  366,  366,  366,  366,  366,  366,  366,  366,  366,  344,  345],
    [ 366,  366,  366,  366,  366,  366,  366,  366,  366,  366,  366,  366,  391,  392,  393,  394,  395,  366,  366,  366,  366,  366,  366,  366,  366,  366,  366,  366,  366],
    [ 366,  366,  366,  366,  366,  366,  366,  366,  366,  366,  366,  366,  421,  422,  423,  424,  425,  366,  366,  366,  366,  366,  366,  366,  366,  366,  366,  366,  366],
    [ 366,  366,  366,  366,  366,  366,  366,  366,  366,  366,  366,  366,  451,  452,  453,  454,  455,  366,  366,  366,  366,  366,  366,  366,  366,  366,  366,  366,  366]
  ],
  "couche1": [
    [   0,  439,  440,    0,    0,    0,    0,  444,    0,    0,    0,    0,  447,    0,    0,    0,  447,    0,    0,    0,    0,  384,    0,    0,    0,  407,  408,    0,    0],
    [   0,  469,  470,    0,    0,  418,    0,  474,    0,    0,    0,    0,  477,    0,    0,    0,  477,    0,    0,    0,    0,    0,  414,    0,    0,  437,  438,    0,  413],
    [   0,    0,    0,    0,    0,  448,    0,  389,    0,    0,    0,  324,    0,    0,    0,    0,    0,    0,    0,  389,    0,    0,    0,  389,    0,  467,  468,    0,  443],
    [ 390,  328,  329,  450,    0,  478,    0,  419,    0,    0,    0,  354,    0,    0,    0,    0,    0,    0,    0,  419,    0,    0,    0,  419,    0,    0,    0,    0,  473],
    [ 420,  358,  359,  480,    0,    0,    0,    0,    0,    0,    0,    0,    0,    0,    0,    0,    0,    0,    0,    0,    0,    0,    0,    0,    0,    0,    0,    0,    0],
    [   0,    0,    0,    0,    0,    0,    0,    0,    0,    0,    0,    0,    0,    0,    0,    0,    0,    0,    0,    0,    0,    0,    0,    0,    0,    0,    0,    0,    0],
    [   0,    0,    0,    0,    0,    0,    0,    0,    0,    0,    0,    0,    0,    0,    0,    0,    0,    0,    0,    0,    0,    0,    0,    0,    0,    0,    0,    0,    0],
    [   0,    0,    0,    0,    0,  238,  239,  239,  239,  239,  239,   60,    0,    0,    0,    0,    0,   58,  239,  239,  239,  239,  239,  240,    0,    0,    0,    0,    0],
    [   0,    0,    0,    0,    0,  206,    0,    0,    0,    0,    0,    0,    0,    0,    0,    0,    0,    0,    0,    0,    0,    0,    0,  207,    0,    0,    0,    0,  147],
    [ 327,    0,    0,    0,    0,  206,    0,    0,    0,    0,    0,    0,    0,    0,    0,    0,    0,    0,    0,    0,    0,    0,    0,  207,    0,    0,    0,    0,  177],
    [ 357,    0,    0,    0,    0,  206,    0,    0,    0,    0,    0,    0,    0,    0,    0,    0,    0,    0,    0,    0,    0,    0,    0,  207,    0,    0,    0,    0,  373],
    [   0,    0,    0,    0,    0,  206,    0,    0,    0,    0,    0,    0,    0,    0,    0,    0,    0,    0,    0,    0,    0,    0,    0,  207,    0,    0,    0,    0,  433],
    [   0,    0,    0,    0,    0,  206,    0,    0,    0,    0,    0,    0,    0,    0,    0,    0,    0,    0,    0,    0,    0,    0,    0,  207,    0,    0,    0,    0,  479],
    [   0,    0,    0,    0,    0,  206,    0,    0,    0,    0,    0,    0,    0,    0,    0,    0,    0,    0,    0,    0,    0,    0,    0,  207,    0,    0,    0,    0,    0],
    [   0,    0,    0,    0,    0,  109,    0,    0,    0,    0,    0,    0,    0,    0,    0,    0,    0,    0,    0,    0,    0,    0,    0,   27,    0,    0,    0,    0,    0],
    [   0,    0,    0,    0,    0,  139,    0,    0,    0,    0,    0,    0,    0,    0,    0,    0,    0,    0,    0,    0,    0,    0,    0,   57,    0,    0,    0,    0,    0],
    [   0,    0,    0,    0,    0,    0,    0,    0,    0,    0,    0,    0,    0,    0,    0,    0,    0,    0,    0,    0,    0,    0,    0,    0,    0,    0,    0,    0,    0],
    [   0,    0,    0,    0,    0,    0,    0,    0,    0,    0,    0,    0,    0,    0,    0,    0,    0,    0,    0,    0,    0,    0,    0,    0,    0,    0,    0,    0,    0],
    [   0,    0,    0,    0,    0,    0,    0,    0,    0,    0,    0,    0,    0,    0,    0,    0,    0,    0,    0,    0,    0,    0,    0,    0,    0,    0,    0,    0,    0],
    [   0,    0,    0,    0,    0,  169,    0,    0,    0,    0,    0,    0,    0,    0,    0,    0,    0,    0,    0,    0,    0,    0,    0,  446,    0,    0,    0,    0,    0],
    [   0,    0,    0,    0,    0,  199,    0,    0,    0,    0,    0,    0,    0,    0,    0,    0,    0,    0,    0,    0,    0,    0,    0,  476,    0,    0,    0,    0,    0],
    [   0,    0,    0,    0,    0,  206,    0,    0,    0,    0,    0,    0,    0,    0,    0,    0,    0,    0,    0,    0,    0,    0,    0,  207,    0,    0,    0,    0,    0],
    [ 327,    0,    0,    0,    0,  206,    0,    0,    0,    0,    0,    0,    0,    0,    0,    0,    0,    0,    0,    0,    0,    0,    0,  207,    0,    0,    0,    0,  324],
    [ 357,    0,    0,    0,    0,  206,    0,    0,    0,    0,    0,    0,    0,    0,    0,    0,    0,    0,    0,    0,    0,    0,    0,  207,    0,    0,    0,    0,  354],
    [   0,    0,    0,    0,    0,  206,    0,    0,    0,    0,    0,    0,    0,    0,    0,    0,    0,    0,    0,    0,    0,    0,    0,  207,    0,    0,    0,    0,  324],
    [   0,    0,    0,    0,    0,  206,    0,    0,    0,    0,    0,    0,    0,    0,    0,    0,    0,    0,    0,    0,    0,    0,    0,  207,    0,    0,    0,    0,  354],
    [   0,    0,    0,    0,    0,   28,    0,    0,    0,    0,    0,    0,    0,    0,    0,    0,    0,    0,    0,    0,    0,    0,    0,   30,    0,    0,    0,    0,    0],
    [   0,    0,    0,    0,    0,   58,  239,  239,  239,  239,  239,   60,    0,    0,    0,    0,    0,   58,  239,  239,  239,  239,  239,   60,    0,    0,    0,    0,    0],
    [   0,    0,    0,    0,    0,    0,    0,    0,    0,    0,    0,    0,    0,    0,    0,    0,    0,    0,    0,    0,    0,    0,    0,    0,    0,    0,    0,    0,    0],
    [   0,    0,    0,    0,    0,    0,    0,    0,    0,    0,    0,    0,    0,    0,    0,    0,    0,    0,    0,    0,    0,    0,    0,    0,    0,    0,    0,    0,    0],
    [   0,    0,    0,    0,    0,    0,    0,    0,    0,    0,    0,    0,    0,    0,    0,    0,    0,    0,    0,    0,    0,    0,    0,    0,    0,    0,    0,    0,    0],
    [ 354,    0,  373,  374,  374,  375,    0,    0,    0,    0,    0,    0,    0,    0,    0,    0,    0,    0,    0,    0,    0,    0,    0,    0,    0,    0,    0,  471,  472]
  ],
  "couche2": [
    [   0,    0,    0,    0,    0,    0,    0,    0,    0,    0,    0,    0,    0,    0,    0,    0,    0,    0,    0,    0,    0,    0,    0,    0,    0,    0,    0,    0,    0],
    [   0,    0,    0,    0,    0,    0,    0,    0,    0,    0,    0,    0,    0,    0,    0,    0,    0,    0,    0,    0,    0,    0,    0,    0,    0,    0,    0,    0,    0],
    [   0,    0,    0,    0,    0,    0,    0,    0,    0,    0,    0,    0,    0,    0,    0,    0,    0,    0,    0,    0,    0,    0,    0,    0,    0,    0,    0,    0,    0],
    [   0,  383,    0,    0,    0,    0,    0,    0,    0,    0,    0,    0,    0,    0,    0,    0,    0,    0,    0,    0,    0,    0,    0,    0,    0,    0,    0,    0,    0],
    [   0,    0,    0,    0,    0,    0,    0,    0,    0,    0,    0,    0,    0,    0,    0,    0,    0,    0,    0,    0,    0,    0,    0,    0,    0,    0,    0,    0,    0],
    [   0,    0,    0,    0,    0,    0,    0,    0,    0,    0,    0,    0,    0,    0,    0,    0,    0,    0,    0,    0,    0,    0,    0,    0,    0,    0,    0,    0,    0],
    [   0,    0,    0,    0,    0,  208,  209,  209,  209,  209,  209,  210,    0,    0,    0,    0,    0,  208,  209,  209,  209,  209,  209,  210,    0,    0,    0,    0,    0],
    [   0,    0,    0,    0,    0,    0,    0,    0,    0,    0,    0,    0,    0,    0,    0,    0,    0,    0,    0,    0,    0,    0,    0,    0,    0,    0,    0,    0,    0],
    [   0,    0,    0,    0,    0,    0,    0,    0,    0,    0,    0,    0,    0,    0,    0,    0,    0,    0,    0,    0,    0,    0,    0,    0,    0,    0,    0,    0,    0],
    [   0,    0,    0,    0,    0,    0,    0,    0,    0,    0,    0,    0,    0,    0,    0,    0,    0,    0,    0,    0,    0,    0,    0,    0,    0,    0,    0,    0,    0],
    [   0,    0,    0,    0,    0,    0,    0,    0,    0,    0,    0,    0,    0,    0,    0,    0,    0,    0,    0,    0,    0,    0,    0,    0,    0,    0,    0,    0,    0],
    [   0,    0,    0,    0,    0,    0,    0,    0,    0,    0,    0,    0,    0,    0,    0,    0,    0,    0,    0,    0,    0,    0,    0,    0,    0,    0,    0,    0,    0],
    [   0,    0,    0,    0,    0,    0,    0,    0,    0,    0,    0,    0,    0,    0,    0,    0,    0,    0,    0,    0,    0,    0,    0,    0,    0,    0,    0,    0,    0],
    [   0,    0,    0,    0,    0,    0,    0,    0,    0,    0,    0,    0,    0,    0,    0,    0,    0,    0,    0,    0,    0,    0,    0,    0,    0,    0,    0,    0,    0],
    [   0,    0,    0,    0,    0,    0,    0,    0,    0,    0,    0,    0,    0,    0,    0,    0,    0,    0,    0,    0,    0,    0,    0,    0,    0,    0,    0,    0,    0],
    [   0,    0,    0,    0,    0,    0,    0,    0,    0,    0,    0,    0,    0,    0,    0,    0,    0,    0,    0,    0,    0,    0,    0,    0,    0,    0,    0,    0,    0],
    [   0,    0,    0,    0,    0,    0,    0,    0,    0,    0,    0,    0,    0,    0,    0,    0,    0,    0,    0,    0,    0,    0,    0,    0,    0,    0,    0,    0,    0],
    [   0,    0,    0,    0,    0,    0,    0,    0,    0,    0,    0,    0,    0,    0,    0,    0,    0,    0,    0,    0,    0,    0,    0,    0,    0,    0,    0,    0,    0],
    [   0,    0,    0,    0,    0,    0,    0,    0,    0,    0,    0,    0,    0,    0,    0,    0,    0,    0,    0,    0,    0,    0,    0,    0,    0,    0,    0,    0,    0],
    [   0,    0,    0,    0,    0,    0,    0,    0,    0,    0,    0,    0,    0,    0,    0,    0,    0,    0,    0,    0,    0,    0,    0,    0,    0,    0,    0,    0,    0],
    [   0,    0,    0,    0,    0,    0,    0,    0,    0,    0,    0,    0,    0,    0,    0,    0,    0,    0,    0,    0,    0,    0,    0,    0,    0,    0,    0,    0,    0],
    [   0,    0,    0,    0,    0,    0,    0,    0,    0,    0,    0,    0,    0,    0,    0,    0,    0,    0,    0,    0,    0,    0,    0,    0,    0,    0,    0,    0,    0],
    [   0,    0,    0,    0,    0,    0,    0,    0,    0,    0,    0,    0,    0,    0,    0,    0,    0,    0,    0,    0,    0,    0,    0,    0,    0,    0,    0,    0,    0],
    [   0,    0,    0,    0,    0,    0,    0,    0,    0,    0,    0,    0,    0,    0,    0,    0,    0,    0,    0,    0,    0,    0,    0,    0,    0,    0,    0,    0,    0],
    [   0,    0,    0,    0,    0,    0,    0,    0,    0,    0,    0,    0,    0,    0,    0,    0,    0,    0,    0,    0,    0,    0,    0,    0,    0,    0,    0,    0,    0],
    [   0,    0,    0,    0,    0,    0,    0,    0,    0,    0,    0,    0,    0,    0,    0,    0,    0,    0,    0,    0,    0,    0,    0,    0,    0,    0,    0,    0,    0],
    [   0,    0,    0,    0,    0,    0,  209,  209,  209,  209,  209,  210,    0,    0,    0,    0,    0,  208,  209,  209,  209,  209,  209,    0,    0,    0,    0,    0,    0],
    [   0,    0,    0,    0,    0,    0,    0,    0,    0,    0,    0,    0,    0,    0,    0,    0,    0,    0,    0,    0,    0,    0,    0,    0,    0,    0,    0,    0,    0],
    [   0,    0,    0,    0,    0,    0,    0,    0,    0,    0,    0,    0,    0,    0,    0,    0,    0,    0,    0,    0,    0,    0,    0,    0,    0,    0,    0,    0,    0],
    [   0,    0,    0,    0,    0,    0,    0,    0,    0,    0,    0,    0,    0,    0,    0,    0,    0,    0,    0,    0,    0,    0,    0,    0,    0,    0,    0,    0,    0],
    [ 324,    0,    0,  330,    0,    0,    0,    0,    0,    0,    0,    0,    0,    0,    0,    0,    0,    0,    0,    0,    0,    0,    0,    0,    0,    0,    0,  441,  442],
    [   0,    0,    0,  360,    0,    0,    0,    0,    0,    0,    0,    0,    0,    0,    0,    0,    0,    0,    0,    0,    0,    0,    0,    0,    0,    0,    0,    0,    0]
  ]
}