{
  "largeur": 15,
  "hauteur": 12,
  "chipset": "PalaisRolandInt.png",
  "musique": "Castle_3.ogg",
  "couche0": [
    [ 527,  527,  527,  527,  527,  527,  527,  527,  527,  527,  527,  527,  527,  527,  527],
    [ 145,  146,  146,  146,  146,  146,    0,    0,    0,  146,  146,  146,  146,  146,  147],
    [ 180,  181,  181,  181,  181,  181,    0,    0,    0,  181,  181,  181,  181,  181,  182],
    [ 215,  216,  216,  216,  216,  216,  225,  225,  225,  216,  216,  216,  216,  216,  217],
    [ 225,  225,  225,  225,  225,  225,  225,  225,  225,  225,  225,  225,  225,  225,  225],
    [ 115,  225,  225,  225,  225,  225,  225,  225,  225,  225,  225,  225,  225,  225,  257],
    [ 147,  225,  225,  225,  121,  122,  122,  122,  122,  122,  123,  225,  225,  225,  145],
    [ 182,  225,  225,  225,  156,  157,  157,  157,  157,  157,  158,  225,  225,  225,  180],
    [ 182,  225,  225,  225,  191,  192,  192,  192,  192,  192,  193,  225,  225,  225,  180],
    [ 182,  225,  225,  225,  225,  225,  225,  225,  225,  225,  225,  225,  225,  225,  180],
    [ 225,  225,  225,  225,  225,  225,  121,  122,  123,  481,  482,  483,  225,  225,  225],
    [ 457,  457,  457,  457,  457,  457,  457,  457,  457,  457,  457,  457,  457,  457,  457]
  ],
  "couche1": [
    [   0,    0,    0,    0,    0,    0,    0,    0,    0,    0,    0,    0,    0,    0,    0],
    [ 480,  262,  470,  470,  470,  263,    0,    0,    0,  262,  470,  470,  470,  263,  480],
    [ 515,  297,  505,  505,  505,  298,    0,    0,    0,  297,  505,  505,  505,  298,  515],
    [  12,  332,  540,  540,  540,  333,  330,    0,  331,  332,  540,  540,  540,  333,   11],
    [  47,    0,    0,    0,    0,    0,    0,    0,    0,    0,    0,    0,    0,    0,   46],
    [   0,    0,    0,    0,    0,    0,    0,    0,    0,    0,    0,    0,    0,    0,    0],
    [ 480,    0,    0,    0,    0,    0,    0,    0,    0,    0,    0,    0,    0,    0,  480],
    [ 515,    0,    0,    0,    0,    0,    0,    0,    0,    0,    0,    0,    0,    0,  515],
    [   0,    0,    0,    0,    0,    0,    0,    0,    0,    0,    0,    0,    0,    0,    0],
    [  11,    0,    0,    0,    0,    0,    0,    0,    0,    0,    0,    0,    0,    0,   12],
    [  46,    0,    0,    0,  378,  379,    0,    0,    0,    0,  448,   63,    0,    0,   47],
    [   0,    0,    0,    0,    0,    0,    0,    0,    0,    0,    0,    0,    0,    0,    0]
  ],
  "couche2": [
    [   0,    0,    0,    0,    0,    0,    0,    0,    0,    0,    0,    0,    0,    0,    0],
    [   0,    0,    0,    0,    0,    0,  260,   21,  261,    0,    0,    0,    0,    0,    0],
    [   0,    0,    0,    0,    0,    0,  295,    0,  296,    0,    0,    0,    0,    0,    0],
    [   0,    0,    0,    0,    0,    0,    0,    0,    0,    0,    0,    0,    0,    0,    0],
    [   0,    0,    0,    0,    0,    0,    0,    0,    0,    0,    0,    0,    0,    0,    0],
    [   0,    0,    0,    0,    0,    0,    0,    0,    0,    0,    0,    0,    0,    0,    0],
    [   0,   29,    0,    0,    0,    0,    0,    0,    0,    0,    0,    0,    0,   30,    0],
    [   0,   64,    0,    0,    0,    0,    0,    0,    0,    0,    0,    0,    0,   65,    0],
    [   0,    0,    0,    0,    0,    0,    0,    0,    0,    0,    0,    0,    0,    0,    0],
    [   0,    0,    0,    0,    0,    0,    0,    0,    0,    0,    0,    0,    0,    0,    0],
    [   0,    0,    0,    0,    0,    0,    0,    0,    0,    0,    0,    0,    0,    0,    0],
    [   0,    0,    0,    0,    0,    0,    0,    0,    0,    0,    0,    0,    0,    0,    0]
  ]
}