{
  "largeur": 15,
  "hauteur": 20,
  "chipset": "PalaisRoland2.png",
  "musique": "Castle_3.ogg",
  "couche0": [
    [ 281,  527,  527,  527,  527,  527,  527,  527,  527,  527,  527,  527,  527,  527,  282],
    [ 493,   58,   58,   58,   58,   58,   58,   58,   58,   58,   58,   58,   58,   58,  491],
    [ 493,   58,   58,   58,   58,   58,   58,   58,   58,   58,   58,   58,   58,   58,  491],
    [ 493,   93,   93,   93,   93,   93,   93,   93,   93,   93,   93,   93,   93,   93,  491],
    [ 528,  358,  358,  358,  359,  361,  361,  361,  361,  361,  357,  358,  358,  358,  526],
    [  59,  358,  358,  358,  359,  361,  361,  361,  361,  361,  357,  358,  358,  358,   59],
    [  59,  358,  358,  358,  359,  361,  361,  361,  361,  361,  357,  358,  358,  358,   59],
    [  59,  358,  358,  358,  359,  361,  361,  361,  361,  361,  357,  358,  358,  358,   59],
    [ 358,  358,  358,  358,  359,  361,  361,  361,  361,  361,  357,  358,  358,  358,  358],
    [ 115,  358,  358,  358,  359,  361,  361,  361,  361,  361,  357,  358,  358,  358,  257],
    [  59,  358,  358,  358,  359,  361,  361,  361,  361,  361,  357,  358,  358,  358,   59],
    [  59,  358,  358,  358,  359,  361,  361,  361,  361,  361,  357,  358,  358,  358,   59],
    [  59,  358,  358,  358,  359,  361,  361,  361,  361,  361,  357,  358,  358,  358,   59],
    [  59,  358,  358,  358,  359,  361,  361,  361,  361,  361,  357,  358,  358,  358,   59],
    [ 358,  358,  358,  358,  359,  361,  361,  361,  361,  361,  357,  358,  358,  358,  358],
    [ 458,  358,  358,  358,  359,  361,  361,  361,  361,  361,  357,  358,  358,  358,  456],
    [ 316,  457,  457,  457,  458,  361,  361,  361,  361,  361,  456,  457,  457,  457,  317],
    [   0,    0,    0,    0,  493,  361,  361,  361,  361,  361,  491,    0,    0,    0,    0],
    [   0,    0,    0,    0,  493,  361,  361,  361,  361,  361,  491,    0,    0,    0,    0],
    [   0,    0,    0,    0,  493,  361,  361,  361,  361,  361,  491,    0,    0,    0,    0]
  ],
  "couche1": [
    [   0,    0,    0,    0,    0,    0,    0,    0,    0,    0,    0,    0,    0,    0,    0],
    [   0,    0,  480,    0,  274,  275,   40,   41,   42,  274,  275,    0,  480,    0,    0],
    [   0,    0,  515,    0,    0,    0,   75,   76,   77,    0,    0,    0,  515,    0,    0],
    [   0,    0,    0,    0,    0,    0,  110,  111,  112,    0,    0,    0,    0,    0,    0],
    [   0,  408,    0,    0,    0,    0,    0,    0,    0,  342,    0,    0,  536,  165,    0],
    [   0,  124,  125,  126,    0,    0,    0,    0,    0,    0,    0,    0,    0,  200,    0],
    [   0,  194,  195,  196,  249,    0,    0,    0,    0,    0,  249,    0,    0,  235,    0],
    [  12,    0,    0,    0,    0,    0,    0,    0,    0,    0,    0,    0,    0,    0,   11],
    [  47,    0,    0,    0,    0,    0,    0,    0,    0,    0,    0,    0,    0,    0,   46],
    [   0,    0,    0,    0,    0,    0,    0,    0,    0,    0,    0,    0,    0,    0,    0],
    [   0,    0,    0,    0,  249,    0,    0,    0,    0,    0,  249,    0,    0,    0,    0],
    [   0,    0,    0,    0,    0,    0,    0,    0,    0,    0,    0,    0,    0,    0,    0],
    [   0,    0,    0,    0,    0,    0,    0,    0,    0,    0,    0,    0,    0,    0,    0],
    [  11,    0,    0,    0,    0,    0,    0,    0,    0,    0,    0,    0,    0,    0,   12],
    [  46,    0,    0,    0,  249,    0,    0,    0,    0,    0,  249,    0,    0,    0,   47],
    [   0,    0,    0,    0,    0,    0,    0,    0,    0,    0,    0,    0,    0,    0,    0],
    [   0,    0,    0,    0,    0,    0,    0,    0,    0,    0,    0,    0,    0,    0,    0],
    [   0,    0,    0,    0,    0,    0,    0,    0,    0,    0,    0,    0,    0,    0,    0],
    [   0,    0,    0,    0,    0,    0,    0,    0,    0,    0,    0,    0,    0,    0,    0],
    [   0,    0,    0,    0,    0,    0,    0,    0,    0,    0,    0,    0,    0,    0,    0]
  ],
  "couche2": [
    [   0,    0,    0,    0,    0,    0,    0,    0,    0,    0,    0,    0,    0,    0,    0],
    [   0,    0,    0,    0,    0,    0,    0,    0,    0,    0,    0,    0,    0,    0,    0],
    [   0,    0,    0,    0,    0,    0,    0,    0,    0,    0,    0,    0,    0,    0,    0],
    [   0,    0,    0,    0,  144,    0,    0,    0,    0,  307,  144,    0,    0,   30,    0],
    [   0,    0,    0,    0,  179,    0,    0,    0,    0,    0,  179,    0,    0,   65,    0],
    [   0,   63,    0,    0,  214,    0,    0,    0,    0,    0,  214,    0,    0,    0,    0],
    [   0,    0,    0,    0,    0,    0,    0,    0,    0,    0,    0,    0,    0,    0,    0],
    [   0,    0,    0,    0,  144,    0,    0,    0,    0,    0,  144,    0,    0,    0,    0],
    [   0,    0,    0,    0,  179,    0,    0,    0,    0,    0,  179,    0,    0,    0,    0],
    [   0,    0,    0,    0,  214,    0,    0,    0,    0,    0,  214,    0,    0,    0,    0],
    [   0,   29,    0,    0,    0,    0,    0,    0,    0,    0,    0,    0,    0,   30,    0],
    [   0,   64,    0,    0,  144,    0,    0,    0,    0,    0,  144,    0,    0,   65,    0],
    [   0,    0,    0,    0,  179,    0,    0,    0,    0,    0,  179,    0,    0,    0,    0],
    [   0,    0,    0,    0,  214,    0,    0,    0,    0,    0,  214,    0,    0,    0,    0],
    [   0,    0,    0,    0,    0,    0,    0,    0,    0,    0,    0,    0,    0,    0,    0],
    [   0,    0,    0,    0,    0,    0,    0,    0,    0,    0,    0,    0,    0,    0,    0],
    [   0,    0,    0,    0,    0,    0,    0,    0,    0,    0,    0,    0,    0,    0,    0],
    [   0,    0,    0,    0,    0,    0,    0,    0,    0,    0,    0,    0,    0,    0,    0],
    [   0,    0,    0,    0,    0,    0,    0,    0,    0,    0,    0,    0,    0,    0,    0],
    [   0,    0,    0,    0,    0,    0,    0,    0,    0,    0,    0,    0,    0,    0,    0]
  ]
}