{
  "largeur": 19,
  "hauteur": 22,
  "chipset": "PalaisRoland2.png",
  "musique": "2000_ordeal.ogg",
  "couche0": [
    [   0,    0,    0,    0,    0,  281,  527,  527,  527,  527,  527,  527,  527,  282,    0,    0,    0,    0,    0],
    [   0,    0,    0,    0,    0,  493,  145,  277,  146,  146,  146,  277,  147,  491,    0,    0,    0,    0,    0],
    [   0,    0,    0,    0,    0,  493,  180,  312,  181,  181,  181,  312,  182,  491,    0,    0,    0,    0,    0],
    [   0,    0,    0,    0,    0,  493,  215,  347,  216,  216,  216,  347,  217,  491,    0,    0,    0,    0,    0],
    [   0,    0,    0,    0,    0,  493,  121,  122,  122,  122,  122,  122,  123,  491,    0,    0,    0,    0,    0],
    [   0,    0,  281,  527,  527,  528,  156,  157,  157,  157,  157,  157,  158,  526,  527,  527,  282,    0,    0],
    [   0,    0,  493,  146,  277,  147,  191,  192,  192,  192,  192,  192,  193,  145,  277,  147,  491,    0,    0],
    [   0,    0,  493,  181,  312,  182,  226,  227,  227,  227,  227,  227,  228,  180,  312,  181,  491,    0,    0],
    [ 281,  527,  528,  216,  347,  217,  121,  122,  122,  122,  122,  122,  123,  215,  347,  216,  526,  527,  282],
    [ 493,  277,  147,  225,  225,  225,  156,  157,  157,  157,  157,  157,  158,  225,  225,  225,  145,  277,  491],
    [ 493,  312,  182,  225,  225,  225,  156,  157,  157,  157,  157,  157,  158,  225,  225,  225,  180,  312,  491],
    [ 493,  347,  217,  225,  225,  225,  156,  157,  157,  157,  157,  157,  158,  225,  225,  225,  215,  347,  491],
    [ 493,  225,  225,  225,  225,  225,  156,  157,  157,  157,  157,  157,  158,  225,  225,  225,  225,  225,  491],
    [ 493,  225,  225,  225,  225,  225,  156,  157,  157,  157,  157,  157,  158,  225,  225,  225,  225,  225,  491],
    [ 493,  225,  225,  225,  225,  225,  156,  157,  157,  157,  157,  157,  158,  225,  225,  225,  225,  225,  491],
    [ 493,  225,  225,  225,  225,  225,  156,  157,  157,  157,  157,  157,  158,  225,  225,  225,  225,  225,  491],
    [ 493,  225,  225,  225,  225,  225,  156,  157,  157,  157,  157,  157,  158,  225,  225,  225,  225,  225,  491],
    [ 316,  457,  458,  225,  225,  225,  156,  157,  157,  157,  157,  157,  158,  225,  225,  225,  456,  457,  317],
    [   0,    0,  316,  457,  457,  457,  457,  458,  157,  157,  157,  456,  457,  457,  457,  457,  317,    0,    0],
    [   0,    0,    0,    0,    0,    0,    0,  493,  157,  157,  157,  491,    0,    0,    0,    0,    0,    0,    0],
    [   0,    0,    0,    0,    0,    0,    0,  493,  157,  157,  157,  491,    0,    0,    0,    0,    0,    0,    0],
    [   0,    0,    0,    0,    0,    0,    0,  316,  457,  457,  457,  317,    0,    0,    0,    0,    0,    0,    0]
  ],
  "couche1": [
    [   0,    0,    0,    0,    0,    0,    0,    0,    0,    0,    0,    0,    0,    0,    0,    0,    0,    0,    0],
    [   0,    0,    0,    0,    0,    0,  480,    0,  278,  279,    0,    0,  480,    0,    0,    0,    0,    0,    0],
    [   0,    0,    0,    0,    0,    0,  515,    0,  313,  314,    0,    0,  515,    0,    0,    0,    0,    0,    0],
    [   0,    0,    0,    0,    0,    0,    0,    0,  348,  349,    0,    0,    0,    0,    0,    0,    0,    0,    0],
    [   0,    0,    0,    0,    0,    0,    0,   52,   53,   54,    0,   55,    0,    0,    0,    0,    0,    0,    0],
    [   0,    0,    0,    0,    0,    0,    0,   87,   88,   89,    0,   90,    0,    0,    0,    0,    0,    0,    0],
    [   0,    0,    0,    0,    0,  480,    0,    0,    0,    0,    0,    0,    0,  480,    0,    0,    0,    0,    0],
    [   0,    0,    0,  429,    0,  515,    0,    0,    0,    0,    0,    0,    0,  515,    0,  429,    0,    0,    0],
    [   0,    0,    0,  370,    0,    0,    0,    0,    0,    0,    0,    0,    0,    0,    0,  370,    0,    0,    0],
    [   0,    0,  480,  405,    0,   91,    0,    0,    0,    0,    0,    0,    0,   91,    0,  405,  480,    0,    0],
    [   0,    0,  515,    0,    0,    0,    0,    0,    0,    0,    0,    0,    0,    0,    0,    0,  515,    0,    0],
    [   0,    0,    0,    0,    0,    0,    0,    0,    0,    0,    0,    0,    0,    0,    0,    0,    0,    0,    0],
    [   0,    0,    0,    0,    0,    0,    0,    0,    0,    0,    0,    0,    0,    0,    0,    0,    0,    0,    0],
    [   0,  381,    0,    0,    0,    0,    0,    0,    0,    0,    0,    0,    0,    0,    0,    0,    0,  381,    0],
    [   0,  416,    0,    0,    0,    0,    0,    0,    0,    0,    0,    0,    0,    0,    0,    0,    0,  416,    0],
    [   0,  451,    0,    0,    0,    0,    0,    0,    0,    0,    0,    0,    0,    0,    0,    0,    0,  451,    0],
    [   0,    0,    0,    0,    0,    0,    0,    0,    0,    0,    0,    0,    0,    0,    0,    0,    0,    0,    0],
    [   0,    0,    0,    0,    0,    0,    0,    0,    0,    0,    0,    0,    0,    0,    0,    0,    0,    0,    0],
    [   0,    0,    0,    0,    0,    0,    0,    0,    0,    0,    0,    0,    0,    0,    0,    0,    0,    0,    0],
    [   0,    0,    0,    0,    0,    0,    0,    0,    0,    0,    0,    0,    0,    0,    0,    0,    0,    0,    0],
    [   0,    0,    0,    0,    0,    0,    0,    0,    0,    0,    0,    0,    0,    0,    0,    0,    0,    0,    0],
    [   0,    0,    0,    0,    0,    0,    0,    0,    0,    0,    0,    0,    0,    0,    0,    0,    0,    0,    0]
  ],
  "couche2": [
    [   0,    0,    0,    0,    0,    0,    0,    0,    0,    0,    0,    0,    0,    0,    0,    0,    0,    0,    0],
    [   0,    0,    0,    0,    0,    0,    0,    0,    0,    0,    0,    0,    0,    0,    0,    0,    0,    0,    0],
    [   0,    0,    0,    0,    0,    0,    0,    0,    0,    0,    0,    0,    0,    0,    0,    0,    0,    0,    0],
    [   0,    0,    0,    0,    0,    0,    0,    0,    0,    0,    0,    0,    0,    0,    0,    0,    0,    0,    0],
    [   0,    0,    0,    0,    0,    0,    0,    0,    0,    0,    0,    0,    0,    0,    0,    0,    0,    0,    0],
    [   0,    0,    0,    0,    0,    0,    0,    0,    0,    0,    0,    0,    0,    0,    0,    0,    0,    0,    0],
    [   0,    0,    0,    0,    0,    0,    0,    0,    0,    0,    0,    0,    0,    0,    0,    0,    0,    0,    0],
    [   0,    0,    0,    0,    0,    0,    0,    0,    0,    0,    0,    0,    0,    0,    0,    0,    0,    0,    0],
    [   0,    0,    0,    0,    0,    0,    0,    0,    0,    0,    0,    0,    0,    0,    0,    0,    0,    0,    0],
    [   0,    0,    0,    0,    0,    0,    0,    0,    0,    0,    0,    0,    0,    0,    0,    0,    0,    0,    0],
    [   0,    0,    0,    0,    0,    0,    0,    0,    0,    0,    0,    0,    0,    0,    0,    0,    0,    0,    0],
    [   0,    0,    0,    0,    0,    0,    0,    0,    0,    0,    0,    0,    0,    0,    0,    0,    0,    0,    0],
    [   0,    0,    0,    0,    0,    0,    0,    0,    0,    0,    0,    0,    0,    0,    0,    0,    0,    0,    0],
    [   0,    0,    0,    0,    0,    0,    0,    0,    0,    0,    0,    0,    0,    0,    0,    0,    0,    0,    0],
    [   0,    0,    0,    0,    0,    0,    0,    0,    0,    0,    0,    0,    0,    0,    0,    0,    0,    0,    0],
    [   0,    0,    0,    0,    0,    0,    0,    0,    0,    0,    0,    0,    0,    0,    0,    0,    0,    0,    0],
    [   0,    0,    0,    0,    0,    0,    0,    0,    0,    0,    0,    0,    0,    0,    0,    0,    0,    0,    0],
    [   0,    0,    0,    0,    0,    0,    0,    0,    0,    0,    0,    0,    0,    0,    0,    0,    0,    0,    0],
    [   0,    0,    0,    0,    0,    0,    0,    0,    0,    0,    0,    0,    0,    0,    0,    0,    0,    0,    0],
    [   0,    0,    0,    0,    0,    0,    0,    0,    0,    0,    0,    0,    0,    0,    0,    0,    0,    0,    0],
    [   0,    0,    0,    0,    0,    0,    0,    0,    0,    0,    0,    0,    0,    0,    0,    0,    0,    0,    0],
    [   0,    0,    0,    0,    0,    0,    0,    0,    0,    0,    0,    0,    0,    0,    0,    0,    0,    0,    0]
  ]
}