{
  "largeur": 19,
  "hauteur": 23,
  "chipset": "PalaisRolandNouveau.png",
  "musique": "2000_ordeal.ogg",
  "couche0": [
    [   0,    0,    0,    0,    0,   56,  101,  101,  101,  101,  101,  101,  101,   55,    0,    0,    0,    0,    0],
    [   0,    0,    0,    0,    0,   54,  145,  146,  146,  146,  146,  146,  147,   52,    0,    0,    0,    0,    0],
    [   0,    0,    0,    0,    0,   54,  193,  194,  194,  194,  194,  194,  195,   52,    0,    0,    0,    0,    0],
    [   0,    0,    0,    0,    0,   54,  193,  194,  194,  194,  194,  194,  195,   52,    0,    0,    0,    0,    0],
    [   0,    0,    0,    0,    0,   54,  241,  242,  242,  242,  242,  242,  243,   52,    0,    0,    0,    0,    0],
    [   0,   56,  101,  101,  101,  102,    1,    2,    2,    2,    2,    2,    3,  100,  101,  101,  101,   55,    0],
    [   0,   54,  145,  146,  146,  147,   49,   50,   50,   50,   50,   50,   51,  145,  146,  146,  147,   52,    0],
    [   0,   54,  193,  194,  194,  195,   97,   98,   98,   98,   98,   98,   99,  193,  194,  194,  195,   52,    0],
    [   0,   54,  193,  194,  194,  195,  489,  490,  490,  490,  490,  490,  491,  193,  194,  194,  195,   52,    0],
    [  56,  102,  241,  242,  242,  243,    1,    2,    2,    2,    2,    2,    3,  241,  242,  242,  243,  100,   55],
    [  54,  147,  734,  734,  734,  734,   49,   50,   50,   50,   50,   50,   51,  734,  734,  734,  734,  145,   52],
    [  54,  195,  734,  734,  734,  734,   49,   50,   50,   50,   50,   50,   51,  734,  734,  734,  734,  193,   52],
    [  54,  243,  734,  734,  734,  734,   49,   50,   50,   50,   50,   50,   51,  734,  734,  734,  734,  241,   52],
    [  54,  734,  734,  734,  734,  734,   49,   50,   50,   50,   50,   50,   51,  734,  734,  734,  734,  734,   52],
    [  54,  734,  734,  734,  734,  734,   49,   50,   50,   50,   50,   50,   51,  734,  734,  734,  734,  734,   52],
    [  54,  734,  734,  734,  734,  734,   49,   50,   50,   50,   50,   50,   51,  734,  734,  734,  734,  734,   52],
    [  54,  734,  734,  734,  734,  734,   49,   50,   50,   50,   50,   50,   51,  734,  734,  734,  734,  734,   52],
    [  54,  734,  734,  734,  734,  734,   49,   50,   50,   50,   50,   50,   51,  734,  734,  734,  734,  734,   52],
    [   8,    5,    6,  734,  734,  734,   97,   98,   50,   50,   50,   98,   99,  734,  734,  734,    4,    5,    7],
    [   0,    0,    8,    5,    5,    5,    5,    6,   49,   50,   51,    4,    5,    5,    5,    5,    7,    0,    0],
    [   0,    0,    0,    0,    0,    0,    0,   54,   49,   50,   51,   52,    0,    0,    0,    0,    0,    0,    0],
    [   0,    0,    0,    0,    0,    0,    0,   54,   97,   98,   99,   52,    0,    0,    0,    0,    0,    0,    0],
    [   0,    0,    0,    0,    0,    0,    0,    8,    5,    5,    5,    7,    0,    0,    0,    0,    0,    0,    0]
  ],
  "couche1": [
    [   0,    0,    0,    0,    0,    0,    0,    0,    0,    0,    0,    0,    0,    0,    0,    0,    0,    0,    0],
    [   0,    0,    0,    0,    0,    0,  335,  569,  570,  571,  572,  573,  335,    0,    0,    0,    0,    0,    0],
    [   0,    0,    0,    0,    0,    0,  383,  617,  618,  619,  620,  621,  383,    0,    0,    0,    0,    0,    0],
    [   0,    0,    0,    0,    0,    0,  515,  665,  666,  667,  668,  669,  516,    0,    0,    0,    0,    0,    0],
    [   0,    0,    0,    0,    0,    0,  563,  713,  714,  715,  716,  717,  564,    0,    0,    0,    0,    0,    0],
    [   0,    0,    0,    0,    0,    0,    0,  315,  316,  317,    0,  192,    0,    0,    0,    0,    0,    0,    0],
    [   0,    0,  574,  575,  576,  335,    0,  363,  364,  365,    0,  240,    0,  335,  574,  575,  576,    0,    0],
    [   0,    0,  622,  623,  624,  383,    0,    0,    0,    0,    0,    0,    0,  383,  622,  623,  624,    0,    0],
    [   0,    0,  670,  671,  672,    0,    0,    0,    0,    0,    0,    0,    0,    0,  670,  671,  672,    0,    0],
    [   0,    0,  718,  719,  720,    0,    0,    0,    0,    0,    0,    0,    0,    0,  718,  719,  720,    0,    0],
    [   0,    0,  326,    0,    0,  132,    0,    0,    0,    0,    0,    0,    0,  132,    0,    0,  326,    0,    0],
    [   0,  513,    0,    0,    0,    0,    0,    0,    0,    0,    0,    0,    0,    0,    0,    0,    0,  514,    0],
    [   0,  561,    0,    0,    0,    0,    0,    0,    0,    0,    0,    0,    0,    0,    0,    0,    0,  562,    0],
    [   0,    0,    0,    0,    0,    0,    0,    0,   44,   45,   46,    0,    0,    0,    0,    0,    0,    0,    0],
    [   0,  232,    0,    0,    0,  754,    0,    0,   92,   93,   94,    0,    0,  755,    0,    0,    0,  231,    0],
    [   0,  280,    0,    0,    0,    0,    0,    0,  140,  141,  142,    0,    0,    0,    0,    0,    0,  279,    0],
    [   0,  328,    0,    0,    0,    0,    0,    0,    0,    0,    0,    0,    0,    0,    0,    0,    0,  327,    0],
    [   0,    0,    0,    0,    0,  384,    0,    0,    0,    0,    0,    0,    0,  384,    0,    0,    0,    0,    0],
    [   0,    0,    0,    0,    0,    0,    0,    0,    0,    0,    0,    0,    0,    0,    0,    0,    0,    0,    0],
    [   0,    0,    0,    0,    0,    0,    0,    0,    0,    0,    0,    0,    0,    0,    0,    0,    0,    0,    0],
    [   0,    0,    0,    0,    0,    0,    0,    0,    0,    0,    0,    0,    0,    0,    0,    0,    0,    0,    0],
    [   0,    0,    0,    0,    0,    0,    0,    0,    0,    0,    0,    0,    0,    0,    0,    0,    0,    0,    0],
    [   0,    0,    0,    0,    0,    0,    0,    0,    0,    0,    0,    0,    0,    0,    0,    0,    0,    0,    0]
  ],
  "couche2": [
    [   0,    0,    0,    0,    0,    0,    0,    0,    0,    0,    0,    0,    0,    0,    0,    0,    0,    0,    0],
    [   0,    0,    0,    0,    0,    0,    0,    0,    0,    0,    0,    0,    0,    0,    0,    0,    0,    0,    0],
    [   0,    0,    0,    0,    0,    0,    0,    0,    0,    0,    0,    0,    0,    0,    0,    0,    0,    0,    0],
    [   0,    0,    0,    0,    0,    0,    0,    0,    0,    0,    0,    0,    0,    0,    0,    0,    0,    0,    0],
    [   0,    0,    0,    0,    0,    0,    0,    0,    0,    0,    0,    0,    0,    0,    0,    0,    0,    0,    0],
    [   0,    0,    0,    0,    0,    0,    0,    0,    0,    0,    0,    0,    0,    0,    0,    0,    0,    0,    0],
    [   0,    0,    0,    0,    0,    0,    0,    0,    0,    0,    0,    0,    0,    0,    0,    0,    0,    0,    0],
    [   0,    0,    0,    0,    0,    0,    0,    0,    0,    0,    0,    0,    0,    0,    0,    0,    0,    0,    0],
    [   0,    0,    0,    0,    0,    0,    0,    0,    0,    0,    0,    0,    0,    0,    0,    0,    0,    0,    0],
    [   0,    0,  278,    0,    0,    0,    0,    0,    0,    0,    0,    0,    0,    0,    0,    0,  278,    0,    0],
    [   0,    0,    0,    0,    0,    0,    0,    0,    0,    0,    0,    0,    0,    0,    0,    0,    0,    0,    0],
    [   0,    0,    0,    0,    0,    0,    0,    0,    0,    0,    0,    0,    0,    0,    0,    0,    0,    0,    0],
    [   0,    0,    0,    0,    0,    0,    0,    0,    0,    0,    0,    0,    0,    0,    0,    0,    0,    0,    0],
    [   0,    0,    0,    0,    0,  706,    0,    0,    0,    0,    0,    0,    0,  707,    0,    0,    0,    0,    0],
    [   0,    0,    0,    0,    0,    0,    0,    0,    0,    0,    0,    0,    0,    0,    0,    0,    0,    0,    0],
    [   0,    0,    0,    0,    0,    0,    0,    0,    0,    0,    0,    0,    0,    0,    0,    0,    0,    0,    0],
    [   0,    0,    0,    0,    0,  336,    0,    0,    0,    0,    0,    0,    0,  336,    0,    0,    0,    0,    0],
    [   0,    0,    0,    0,    0,    0,    0,    0,    0,    0,    0,    0,    0,    0,    0,    0,    0,    0,    0],
    [   0,    0,    0,    0,    0,    0,    0,    0,    0,    0,    0,    0,    0,    0,    0,    0,    0,    0,    0],
    [   0,    0,    0,    0,    0,    0,    0,    0,    0,    0,    0,    0,    0,    0,    0,    0,    0,    0,    0],
    [   0,    0,    0,    0,    0,    0,    0,    0,    0,    0,    0,    0,    0,    0,    0,    0,    0,    0,    0],
    [   0,    0,    0,    0,    0,    0,    0,    0,    0,    0,    0,    0,    0,    0,    0,    0,    0,    0,    0],
    [   0,    0,    0,    0,    0,    0,    0,    0,    0,    0,    0,    0,    0,    0,    0,    0,    0,    0,    0]
  ]
}