{
  "largeur": 25,
  "hauteur": 40,
  "chipset": "chipset173.png",
  "musique": "cc_viper_manor.ogg",
  "couche0": [
    [ 618,  618,  618,  618,  618,  618,  618,  618,  618,  618,  618,  618,  618,  618,  618,  618,  618,  618,  618,  618,  618,  618,  618,  101,  102],
    [ 662,  662,  114,  114,  114,  114,  114,  114,  114,  114,  114,  114,  114,  114,  114,  114,  114,  114,  114,  114,  114,  114,  114,  101,  102],
    [ 183,  442,  114,  114,  114,  114,  114,  213,  214,  218,  219,  213,  214,  218,  219,  220,  114,  114,  114,  114,  114,  114,  114,  101,  102],
    [ 442,  529,  213,  214,  218,  219,  220,  213,  214,  218,  218,  219,  218,  218,  219,  220,  213,  214,  213,  214,  218,  219,  220,  101,  102],
    [ 574,  574,  213,  214,  218,  219,  220,  629,  630,  630,  630,  630,  630,  630,  630,  631,  213,  214,  218,  218,  218,  219,  220,  101,  102],
    [ 618,  662,  629,  630,  630,  630,  631,  629,  630,  630,  630,    0,  630,  630,  630,  631,  629,  631,  631,  631,  631,  631,  631,  145,   38],
    [ 619,  183,  629,  630,  630,  630,  631,  673,  674,  674,  674,    0,  674,  674,  674,  675,  629,  631,  631,  631,  631,  631,  631,  192,  145],
    [ 618,  574,  673,  674,  674,  674,  675,  127,  127,  127,  127,  127,  127,  127,  127,  127,  673,  675,  675,  675,  675,  675,  675,  236,  192],
    [  82,   83,   83,   83,   83,   83,   83,   83,   83,   83,  127,  127,  127,   83,   83,   83,   83,   83,   83,   83,   83,   83,   84,  189,  236],
    [ 126,   82,  127,  127,  127,  127,  127,  127,  127,  127,  127,  127,  127,  127,  127,  127,  127,  127,  127,  127,  127,  127,  127,   84,  189],
    [ 170,   82,  171,  171,  171,  171,  171,  171,  171,  171,  127,  127,  127,  171,  171,  171,  171,  171,  171,  171,  171,  171,  171,  172,   39],
    [ 662,  618,  618,  618,  662,  618,  618,  618,  618,  618,  126,  127,  128,  618,  618,  618,  662,  618,  618,  662,  662,  662,  662,  618,   38],
    [ 183,  617,  618,  619,  183,  617,  618,  618,  618,  618,  126,  127,  128,  618,  618,  619,  183,  617,  619,  443,  443,  443,  443,  661,   39],
    [ 574,  618,  618,  618,  574,  618,  618,  618,  618,  618,  170,  171,  172,  618,  618,  618,  574,  618,  663,  183,  443,  443,   19,   20,  662],
    [ 618,  618,  618,  618,  618,  618,  662,  618,  618,  618,   82,   83,   84,  618,  618,  662,  662,  663,   11,  359,   11,   11,   63,   64,   11],
    [ 661,  662,  662,  662,  618,  619,  183,  617,   84,  618,  126,  127,  128,  618,  619,  443,  183,   11,  239,   11,   11,   11,   11,   11,   11],
    [ 486,  486,  486,  486,  617,  618,  574,  618,  128,  618,  126,  127,  128,  618,  618,  574,  575,   11,  283,   11,  327,   11,  240,  241,  242],
    [ 486,  361,  486,  486,  617,  618,  126,  127,  128,  618,  170,  171,  128,  618,  618,  618,  619,   11,  183,   11,  361,   11,  183,   11,  239],
    [ 486,  486,  486,  486,  617,  618,  170,  171,  172,  618,  618,  618,  618,  618,  618,  618,  619,   11,  243,  244,   11,   11,   11,   11,  283],
    [ 486,  486,  486,  573,  618,  618,  618,  618,  618,  618,  126,  127,   38,  618,   38,  618,  619,   11,  287,  288,   11,   11,   11,   11,   11],
    [ 574,  574,  574,  618,  662,  618,  618,   38,  618,  618,   82,  127,  128,  618,  618,  618,  619,   11,   11,   11,  234,  618,  618,  618,  618],
    [ 618,   38,  618,  619,  183,  617,  618,  618,  618,  618,  126,   84,  128,  618,  618,  618,  234,  618,  618,  186,  618,  618,  662,  662,  662],
    [ 618,  618,  618,  618,  574,  618,  618,  618,  618,  618,  126,  127,   84,  618,  101,  102,  618,  618,  618,  618,  618,  619,  442,  183,  442],
    [ 618,  618,  618,  618,  618,  618,  618,  618,  618,  618,  170,  171,  172,  618,  145,  146,  618,  147,   81,  145,  146,  278,  574,  574,  574],
    [ 618,  618,  618,  618,  618,  618,  618,  618,  618,  618,   82,   83,  128,  618,  192,  193,  193,  194,  125,  192,  193,  145,  146,  278,  618],
    [ 618,  618,  618,  618,  618,  618,  618,  618,  618,  618,  126,  127,  128,  618,  236,  237,  237,  238,   81,  236,  237,  192,  193,  145,  146],
    [ 618,  618,  618,  618,  618,  618,  618,  618,  618,  618,  170,  127,  172,  618,  189,  190,  190,  191,  618,  189,  190,  236,  237,  192,  193],
    [ 618,  618,  618,  618,  618,  618,  618,  618,  618,  618,   39,  170,  172,  618,  618,  618,  618,  618,  618,  618,  618,  189,  190,  236,  237],
    [ 618,  213,  214,  215,  217,  217,  217,  218,  219,  220,   84,   38,   39,  618,  618,  618,  618,  618,  618,  618,  618,  618,  618,  189,  190],
    [ 618,  213,  214,  215,  217,  217,  217,  218,  219,  220,  126,   84,   39,  618,  618,  618,  618,  618,  627,  627,  627,  627,  618,  662,  662],
    [ 618,  629,  630,  630,  630,  630,  630,  630,  630,  631,  126,  127,   84,  618,   38,  618,  618,  618,  627,  627,  618,  627,  486,  486,  486],
    [ 618,  629,  630,  630,  630,  630,  630,  630,  630,  631,  126,  127,  128,  618,  618,  618,  618,  618,  618,  618,  618,  486,  400,  401,  401],
    [ 618,  673,  674,  674,  674,  674,  674,  674,  674,  675,  126,  127,  128,  618,  618,  618,  618,  618,  662,  618,  619,  486,  444,  445,  445],
    [ 618,  618,  618,  618,  618,  662,  662,  618,  618,  618,  126,  127,  128,  618,  618,  618,  618,  619,  183,  617,  619,  183,  488,  489,  489],
    [ 618,  618,  445,  445,  402,  530,  530,  617,  618,  618,  126,  127,  128,  618,  618,  618,  618,  618,  574,  618,  618,  574,  574,  575,  486],
    [  38,  618,  445,  445,  446,  530,  530,  617,  618,  618,  170,  127,  128,  618,  618,  618,  618,  618,   82,   83,   83,   84,  618,  618,  574],
    [ 618,  618,  445,  445,  490,  183,  530,  617,  618,  618,  102,  170,  172,  618,  618,   82,   83,   83,  127,  127,  127,  128,  618,  618,  618],
    [ 618,  618,  618,  618,  618,  575,  530,  661,  618,  618,  186,  102,  102,   38,  618,  170,  127,  127,  127,  127,  127,  128,  618,  618,  618],
    [ 618,  618,  618,  618,  102,  619,  530,  530,  661,  102,  102,   38,  102,  102,  102,  102,  170,  171,  171,  171,  171,  172,  102,  618,  618],
    [ 618,  102,  102,  102,  102,  619,  530,  183,  530,  617,  102,  102,  102,  102,  102,  102,  102,  102,  102,  102,  102,  102,  102,  102,  618]
  ],
  "couche1": [
    [ 377,    0,    0,    0,    0,    0,    0,  612,  613,  612,  613,  612,  613,  612,  612,  613,    0,    0,    0,    0,    0,    0,    0,    0,    0],
    [ 421,  245,  609,  610,  611,  612,  613,  656,  657,  656,  657,  656,  657,  656,  656,  657,  612,  613,  612,  613,  614,  615,  616,    0,    0],
    [ 465,  289,  653,  654,  655,  656,  657,  700,  701,  700,  701,  700,  701,  700,  700,  701,  656,  657,  656,  657,  658,  659,  660,    0,    0],
    [   0,    0,  697,  698,  699,  700,  701,  129,  130,  131,   41,   42,   43,  129,  130,  131,  700,  701,  700,  701,  702,  703,  704,    0,  377],
    [   0,    0,  504,    0,  505,    0,  506,   72,   73,   74,   69,   70,   71,   72,   73,   74,  506,    0,    0,    0,  507,    0,    0,    0,  421],
    [ 337,  338,  548,  454,  549,    0,  550,  116,  117,  118,  113,  114,  115,  116,  117,  118,  550,    0,  365,    0,  551,  337,  338,    0,  465],
    [ 381,  382,  548,  498,  549,    0,  550,  160,  161,  162,  157,  158,  159,  160,  161,  162,  550,    0,  409,    0,  551,  381,  382,    0,    0],
    [ 425,  426,  592,    0,  593,    0,  594,  204,  205,  206,  201,  202,  203,  204,  205,  206,  594,    0,  637,    0,  595,  425,  426,    0,    0],
    [   0,    0,  346,    0,  346,    0,  346,    0,    0,    0,    0,    0,    0,  248,  249,  250,  346,    0,  346,    0,  346,    0,    0,    0,    0],
    [   0,    0,    0,    0,    0,    0,    0,    0,    0,    0,    0,    0,    0,  292,  293,  294,    0,    0,    0,    0,    0,    0,    0,    0,    0],
    [   0,    0,    0,    0,    0,    0,    0,    0,    0,    0,    0,    0,    0,    0,    0,    0,    0,    0,    0,    0,    0,    0,    0,    0,    0],
    [   0,  424,    0,    0,    0,  601,  602,  333,  465,    0,    0,    0,    0,    0,    0,  685,  686,  687,  688,    0,    0,    0,    0,    0,    0],
    [ 334,  335,  336,    0,    0,    0,  334,  335,  336,    0,    0,    0,    0,  334,  335,  336,    0,    0,    0,    0,  331,    0,    0,    0,    0],
    [ 378,  379,  380,  466,  467,  468,  378,  379,  380,    0,    0,    0,    0,  378,  379,  380,  466,  467,  468,    0,    0,    0,    0,    0,    0],
    [   0,    0,    0,    0,    0,    0,    0,    0,    0,    0,    0,    0,    0,    0,    0,    0,    0,    0,    0,    0,    0,    0,    0,    0,  594],
    [   0,  248,  249,  250,    0,    0,  334,  335,  333,    0,    0,    0,    0,    0,    0,    0,    0,    0,    0,    0,    0,    0,    0,    0,  111],
    [   0,  292,  293,  294,    0,    0,  246,  247,  377,    0,    0,    0,    0,  377,    0,    0,    0,    0,    0,    0,    0,    0,    0,    0,    0],
    [   0,    0,    0,    0,    0,    0,  290,  291,  421,    0,    0,    0,    0,  421,    0,    0,    0,    0,    0,    0,    0,    0,    0,    0,    0],
    [   0,    0,  689,  690,    0,    0,    0,    0,  465,    0,    0,    0,    0,  465,    0,    0,    0,    0,    0,    0,    0,    0,    0,    0,    0],
    [   0,  680,    0,    0,  466,  467,  468,    0,    0,    0,    0,    0,    0,    0,    0,    0,    0,    0,    0,    0,  459,  460,  460,  460,  460],
    [   0,    0,    0,    0,    0,    0,    0,    0,    0,    0,    0,    0,    0,    0,    0,    0,  459,  460,  460,  460,  685,  686,  687,  688,    0],
    [   0,    0,    0,    0,    0,    0,    0,    0,  374,  376,    0,    0,    0,    0,  459,  460,  601,  602,    0,    0,    0,    0,    0,    0,  377],
    [   0,    0,    0,    0,    0,    0,    0,    0,  418,  347,  376,    0,    0,    0,    0,    0,    0,    0,    0,    0,    0,    0,    0,    0,  421],
    [   0,    0,    0,    0,    0,    0,    0,    0,  462,  463,  463,    0,    0,    0,    0,    0,    0,    0,    0,    0,    0,    0,    0,    0,  465],
    [   0,  521,  522,  523,  524,  524,  525,  526,  527,  528,    0,    0,    0,    0,    0,    0,    0,    0,    0,    0,    0,    0,    0,    0,    0],
    [   0,  521,  522,  523,  524,  524,  525,  526,  527,  528,    0,    0,    0,    0,    0,    0,    0,    0,    0,    0,    0,    0,    0,    0,    0],
    [   0,  565,  566,  567,  568,  568,  569,  570,  571,  572,    0,    0,    0,    0,    0,    0,    0,    0,    0,    0,    0,    0,    0,    0,    0],
    [   0,  653,  654,  655,  656,  656,  657,  658,  659,  660,    0,    0,    0,  248,  249,  250,    0,    0,    0,    0,    0,    0,    0,    0,    0],
    [   0,  697,  698,  699,  700,  700,  701,  700,  703,  704,    0,    0,    0,  292,  293,  294,    0,  374,  375,  375,  375,  376,    0,    0,    0],
    [   0,    0,    0,    0,    0,  129,  130,  131,    0,    0,    0,    0,    0,    0,    0,    0,    0,  418,  246,  247,    0,  347,  376,    0,    0],
    [   0,    0,    0,    0,    0,  173,   73,  175,    0,  635,    0,    0,    0,    0,    0,    0,    0,  418,  290,  291,  419,    0,  420,    0,    0],
    [   0,    0,    0,    0,    0,  116,  117,  118,    0,  547,    0,    0,    0,    0,    0,    0,  681,  462,  463,  463,  463,  463,  463,    0,    0],
    [   0,    0,    0,    0,    0,  160,  161,  162,    0,  547,    0,    0,    0,  377,    0,    0,    0,    0,    0,    0,    0,  601,  602,    0,    0],
    [   0,  374,  375,  375,  376,  204,  205,  206,  679,  591,    0,    0,    0,  421,  466,  467,  468,    0,    0,    0,    0,    0,    0,  682,    0],
    [   0,  418,  259,  260,  464,    0,    0,    0,    0,  346,    0,    0,    0,  465,  689,  690,  334,  335,  336,    0,    0,    0,    0,    0,    0],
    [   0,  418,  303,  685,  686,  687,  688,    0,  377,    0,    0,    0,    0,    0,    0,  378,  379,  380,    0,    0,    0,    0,    0,    0,    0],
    [   0,  418,  347,  375,  376,  682,    0,  466,  467,  468,    0,    0,    0,    0,    0,    0,    0,    0,    0,  333,  334,  335,  336,    0,    0],
    [   0,  462,  261,  419,  420,    0,    0,    0,    0,    0,    0,    0,    0,    0,    0,    0,    0,    0,  681,  377,    0,  333,    0,    0,    0],
    [   0,    0,  462,  463,  464,    0,    0,    0,    0,    0,    0,    0,    0,    0,    0,    0,    0,    0,    0,  421,    0,    0,    0,    0,    0],
    [   0,    0,    0,    0,    0,    0,    0,    0,    0,    0,    0,    0,    0,    0,    0,    0,    0,    0,    0,  465,  466,  467,  468,    0,    0]
  ],
  "couche2": [
    [   0,    0,    0,    0,    0,    0,    0,    0,    0,    0,    0,    0,    0,    0,    0,    0,    0,    0,    0,    0,    0,    0,    0,    0,    0],
    [   0,    0,    0,    0,    0,    0,    0,    0,    0,    0,    0,    0,    0,    0,    0,    0,    0,    0,    0,    0,    0,    0,    0,    0,    0],
    [   0,    0,    0,    0,    0,    0,    0,    0,    0,    0,    0,    0,    0,    0,    0,    0,    0,    0,    0,    0,    0,    0,    0,    0,    0],
    [   0,    0,    0,    0,    0,    0,    0,    0,    0,    0,    0,    0,    0,    0,    0,    0,    0,    0,    0,    0,    0,    0,    0,    0,    0],
    [   0,    0,    0,    0,    0,    0,    0,    0,    0,    0,    0,    0,    0,    0,    0,    0,    0,    0,    0,    0,    0,    0,    0,    0,    0],
    [   0,    0,    0,    0,    0,    0,    0,    0,    0,    0,    0,    0,    0,    0,    0,    0,    0,    0,    0,    0,    0,    0,    0,    0,    0],
    [   0,    0,    0,    0,    0,    0,    0,    0,    0,    0,    0,    0,    0,    0,    0,    0,    0,    0,    0,    0,    0,    0,    0,    0,    0],
    [   0,    0,    0,    0,    0,    0,    0,    0,    0,    0,    0,    0,    0,    0,    0,  509,  510,  511,  512,    0,    0,    0,    0,    0,    0],
    [   0,    0,    0,    0,    0,    0,    0,    0,    0,    0,    0,    0,    0,    0,    0,  553,  554,  555,  556,    0,    0,    0,    0,    0,    0],
    [   0,    0,    0,    0,    0,    0,    0,    0,    0,    0,    0,    0,    0,    0,    0,  597,  598,  599,  600,    0,    0,    0,    0,    0,    0],
    [   0,    0,    0,    0,    0,  557,  558,    0,    0,    0,    0,    0,    0,    0,    0,  641,  642,  643,  644,    0,    0,    0,    0,    0,    0],
    [   0,    0,    0,    0,    0,    0,    0,    0,    0,    0,    0,    0,    0,    0,    0,    0,    0,    0,    0,    0,  245,    0,    0,    0,    0],
    [   0,    0,    0,  422,  423,    0,    0,    0,    0,    0,    0,    0,    0,    0,    0,    0,  422,  423,    0,    0,    0,    0,    0,    0,  638],
    [   0,    0,    0,    0,    0,    0,    0,    0,    0,    0,    0,    0,    0,    0,    0,    0,    0,    0,    0,    0,    0,    0,    0,    0,  550],
    [   0,    0,    0,    0,    0,    0,    0,    0,    0,    0,    0,    0,    0,    0,    0,    0,    0,    0,    0,    0,    0,    0,    0,    0,    0],
    [   0,    0,    0,    0,    0,    0,    0,    0,    0,    0,    0,    0,    0,    0,    0,    0,    0,    0,    0,    0,    0,    0,    0,    0,    0],
    [   0,    0,    0,    0,    0,    0,    0,    0,    0,    0,    0,    0,    0,    0,    0,    0,    0,    0,    0,    0,  509,  510,  511,  512,    0],
    [   0,    0,  645,  646,    0,    0,    0,    0,    0,    0,    0,    0,    0,    0,    0,    0,    0,    0,    0,    0,  553,  554,  555,  556,    0],
    [   0,    0,    0,    0,  422,  423,    0,    0,    0,    0,    0,    0,    0,    0,    0,    0,    0,    0,    0,    0,  597,  598,  599,  600,    0],
    [   0,    0,    0,    0,    0,    0,    0,    0,    0,    0,    0,    0,    0,    0,    0,    0,    0,    0,    0,    0,  641,  642,  643,  644,    0],
    [   0,    0,    0,    0,    0,    0,    0,    0,    0,    0,    0,    0,    0,    0,    0,    0,  557,  558,    0,    0,    0,    0,    0,    0,    0],
    [   0,    0,    0,    0,    0,    0,    0,    0,    0,    0,    0,    0,    0,    0,    0,    0,    0,    0,    0,    0,    0,    0,    0,    0,    0],
    [   0,  389,  390,  391,  392,  393,  393,  394,  395,  396,    0,    0,    0,    0,    0,    0,    0,    0,    0,    0,    0,    0,    0,    0,    0],
    [   0,  433,  434,  435,  436,  437,  437,  438,  439,  440,    0,    0,    0,    0,    0,    0,    0,    0,    0,    0,    0,    0,    0,    0,    0],
    [   0,    0,    0,    0,    0,    0,    0,    0,    0,    0,    0,    0,    0,    0,    0,    0,    0,    0,    0,    0,    0,    0,    0,    0,    0],
    [   0,    0,    0,    0,    0,    0,    0,    0,    0,    0,    0,    0,    0,    0,    0,    0,    0,    0,    0,    0,    0,    0,    0,    0,    0],
    [   0,    0,    0,    0,    0,    0,    0,    0,    0,    0,    0,    0,    0,    0,    0,    0,    0,    0,    0,    0,    0,    0,    0,    0,    0],
    [   0,    0,    0,    0,    0,    0,    0,    0,    0,    0,    0,    0,    0,    0,    0,    0,    0,    0,    0,    0,    0,    0,    0,    0,    0],
    [   0,    0,    0,    0,    0,    0,    0,    0,    0,    0,    0,    0,    0,    0,    0,    0,    0,    0,    0,    0,    0,    0,    0,    0,    0],
    [   0,    0,    0,    0,    0,    0,    0,    0,    0,    0,    0,    0,    0,    0,    0,    0,    0,    0,    0,    0,    0,    0,    0,    0,    0],
    [   0,    0,    0,    0,    0,    0,    0,    0,    0,    0,    0,    0,    0,    0,    0,    0,    0,    0,    0,    0,    0,    0,    0,    0,    0],
    [   0,    0,    0,  509,  510,  511,  512,    0,    0,    0,    0,    0,    0,    0,    0,    0,    0,    0,    0,    0,    0,  557,  558,    0,    0],
    [   0,    0,    0,  553,  554,  555,  556,    0,    0,    0,    0,    0,    0,    0,  422,  423,    0,    0,    0,    0,    0,    0,    0,    0,    0],
    [   0,    0,    0,  597,  598,  599,  600,    0,    0,    0,    0,    0,    0,    0,  645,  646,    0,    0,    0,    0,    0,    0,    0,    0,    0],
    [   0,    0,    0,  641,  642,  643,  644,    0,    0,    0,    0,    0,    0,    0,    0,    0,    0,    0,    0,    0,    0,    0,    0,    0,    0],
    [   0,    0,    0,    0,    0,    0,    0,  422,  423,    0,    0,    0,    0,    0,    0,    0,    0,    0,    0,    0,    0,    0,    0,    0,    0],
    [   0,    0,    0,    0,    0,    0,    0,    0,    0,    0,    0,    0,    0,    0,    0,    0,    0,    0,    0,    0,    0,    0,    0,    0,    0],
    [   0,    0,    0,    0,    0,    0,    0,    0,    0,    0,    0,    0,    0,    0,    0,    0,    0,    0,    0,    0,    0,    0,    0,    0,    0],
    [   0,    0,    0,    0,    0,    0,    0,    0,    0,    0,    0,    0,    0,    0,    0,    0,    0,    0,    0,    0,  422,  423,    0,    0,    0],
    [   0,    0,    0,    0,    0,    0,    0,    0,    0,    0,    0,    0,    0,    0,    0,    0,    0,    0,    0,    0,    0,    0,    0,    0,    0]
  ]
}