{
  "largeur": 20,
  "hauteur": 18,
  "chipset": "marais2.png",
  "musique": "cc_viper_manor.ogg",
  "couche0": [
    [   0,    0,    0,    0,    0,    0,    0,    0,    0,    0,    0,    0,    0,    0,    0,    0,    0,    0,    0,    0],
    [   0,    0,    0,    0,    0,    0,    0,    0,    0,    0,    0,    0,    0,    0,    0,    0,    0,    0,    0,    0],
    [   0,    0,    0,    0,    0,    0,    0,    0,    0,    0,    0,    0,    0,    0,    0,    0,    0,    0,    0,    0],
    [   0,    0,    0,    0,    0,    0,    0,    0,    0,    0,    0,    0,    0,    0,    0,    0,    0,    0,    0,    0],
    [   0,    0,    0,    0,    0,    0,    0,    0,    0,    0,    0,    0,    0,    0,    0,    0,    0,    0,    0,    0],
    [  40,   19,    9,    1,    1,    1,    1,  304,  305,  306,    1,    7,   19,   14,   14,  133,   14,   14,   73,   74],
    [  37,   13,    9,    1,    1,    1,    1,  304,  305,  306,    1,   37,  133,   13,   14,   43,   44,   45,  103,  104],
    [  67,   37,   39,    1,    1,    1,    1,  304,  305,  306,    1,   67,   37,   40,   43,   74,   15,  105,   19,   14],
    [  97,   67,   69,  421,    1,    1,    1,  304,  305,  306,  407,   97,   67,   37,   38,   38,   38,   38,   14,   14],
    [ 127,   97,   99,  421,    1,    1,    1,  304,  305,  306,  437,  127,   97,   67,   68,   68,   68,   68,   37,   40],
    [ 467,  127,  129,  421,    1,    1,    1,  304,  305,  306,  467,  393,  127,   97,   98,   98,   98,   98,   67,    7],
    [ 381,  467,  391,  469,    1,    1,    1,  334,  273,  331,  276,  467,  393,  127,  128,  128,  128,  128,   97,    7],
    [ 381,  381,  381,  381,  381,  381,    1,    1,  334,  273,  331,  276,  467,  392,  392,  392,  392,  393,  127,    7],
    [ 381,  381,  381,  381,  381,  381,  381,    1,    1,  334,  273,  331,  275,  275,  333,  305,  306,  467,  392,    7],
    [ 292,  381,  290,  292,  381,  381,  381,  381,    1,    1,  334,  273,  305,  305,  305,  271,  336,    1,    1,    7],
    [ 322,  381,  350,  352,  381,  290,  291,  292,  381,    1,    1,  334,  335,  335,  335,  336,    1,    1,    1,    7],
    [ 322,  381,  381,  381,  381,  350,  351,  352,  381,  381,    1,    1,    1,    1,    1,    1,    1,    1,    1,    7],
    [ 352,  381,  381,  381,  381,  381,  381,  381,  381,  381,    1,    1,    1,    1,    1,    1,    1,    1,    1,    7]
  ],
  "couche1": [
    [   0,    0,    0,    0,    0,    0,    0,    0,    0,    0,    0,    0,    0,    0,    0,    0,    0,    0,    0,    0],
    [   0,    0,    0,    0,    0,    0,    0,    0,    0,    0,    0,    0,    0,    0,    0,    0,    0,    0,    0,    0],
    [   0,    0,    0,    0,    0,    0,    0,    0,    0,    0,    0,    0,    0,    0,    0,    0,    0,    0,    0,    0],
    [   0,    0,    0,    0,    0,    0,    0,    0,    0,    0,    0,    0,    0,    0,    0,    0,    0,    0,    0,    0],
    [   0,    0,    0,    0,    0,    0,    0,    0,    0,    0,    0,    0,    0,    0,    0,    0,    0,    0,    0,    0],
    [   0,    0,    0,    0,    0,    0,    0,    0,    0,    0,    0,    0,    0,  477,  478,  479,    0,    0,    0,    0],
    [   0,    0,    0,  477,  478,  479,    0,    0,    0,    0,    0,    0,    0,    0,    0,    0,    0,    0,    0,    0],
    [   0,    0,    0,    0,    0,    0,    0,    0,    0,    0,    0,    0,    0,    0,    0,    0,    0,    0,    0,    0],
    [   0,    0,    0,  431,    0,    0,  433,    0,    0,    0,    0,    0,    0,    0,    0,    0,    0,    0,    0,    0],
    [   0,    0,    0,    0,  235,  236,  237,    0,    0,    0,    0,    0,    0,    0,    0,    0,    0,    0,    0,    0],
    [ 415,    0,    0,    0,  265,  266,  267,    0,    0,    0,    0,    0,    0,    0,    0,    0,    0,    0,    0,    0],
    [   0,  415,    0,    0,  295,  296,  297,    0,    0,    0,    0,    0,    0,    0,    0,    0,    0,    0,    0,    0],
    [   0,    0,    0,    0,    0,    0,  415,    0,    0,    0,    0,    0,    0,  175,  176,  177,  178,  179,    0,    0],
    [   0,    0,    0,    0,    0,    0,    0,  415,    0,    0,    0,    0,    0,  205,  206,  207,  208,  209,    0,    0],
    [   0,    0,    0,    0,    0,    0,    0,    0,  415,    0,    0,    0,    0,    0,    0,    0,    0,    0,    0,    0],
    [   0,    0,    0,    0,    0,    0,    0,    0,    0,  415,    0,    0,  235,  236,  237,    0,    0,    0,    0,    0],
    [   0,    0,    0,    0,    0,    0,    0,    0,    0,    0,    0,    0,  265,  266,  267,    0,    0,  268,  269,    0],
    [   0,    0,    0,    0,    0,    0,    0,    0,    0,    0,    0,    0,  295,  296,  297,    0,    0,    0,    0,    0]
  ],
  "couche2": [
    [   0,    0,    0,    0,    0,    0,    0,    0,    0,    0,    0,    0,  326,  327,  328,  329,  330,    0,    0,    0],
    [   0,    0,  326,  327,  328,  329,  330,    0,    0,    0,    0,    0,  356,  357,  358,  359,  360,    0,    0,    0],
    [   0,    0,  356,  357,  358,  359,  360,    0,    0,    0,    0,    0,  386,  387,  388,  389,  390,    0,    0,    0],
    [   0,    0,  386,  387,  388,  389,  390,    0,    0,    0,    0,    0,  416,  417,  418,  419,  420,    0,    0,    0],
    [   0,    0,  416,  417,  418,  419,  420,    0,    0,    0,    0,    0,    0,  447,  448,  449,    0,    0,    0,    0],
    [   0,    0,    0,  447,  448,  449,    0,    0,    0,    0,    0,    0,    0,    0,    0,    0,    0,    0,    0,    0],
    [   0,    0,    0,    0,    0,    0,    0,    0,    0,    0,    0,    0,    0,    0,    0,    0,    0,    0,    0,    0],
    [   0,    0,    0,  401,  402,  402,  403,    0,    0,    0,    0,    0,    0,    0,   26,   27,   28,    0,    0,    0],
    [   0,    0,    0,    0,    0,    0,    0,    0,    0,    0,    0,    0,    0,   55,   56,   57,   58,   59,    0,    0],
    [   0,    0,    0,    0,    0,    0,    0,    0,    0,    0,    0,    0,    0,   85,   86,   87,   88,   89,    0,    0],
    [   0,    0,    0,    0,    0,    0,    0,    0,    0,    0,    0,    0,    0,  115,  116,  117,  118,  119,    0,    0],
    [   0,    0,    0,    0,    0,    0,    0,    0,    0,    0,    0,    0,    0,  145,  146,  147,  148,  149,    0,    0],
    [   0,    0,    0,    0,    0,    0,    0,    0,    0,    0,    0,    0,    0,    0,    0,    0,    0,    0,    0,    0],
    [   0,    0,    0,    0,    0,    0,    0,    0,    0,    0,    0,    0,    0,    0,    0,    0,    0,    0,    0,    0],
    [   0,    0,    0,    0,    0,    0,    0,    0,    0,    0,    0,    0,    0,    0,    0,    0,    0,    0,    0,    0],
    [   0,    0,    0,    0,    0,    0,    0,    0,    0,    0,    0,    0,    0,    0,    0,    0,    0,  238,  239,    0],
    [   0,    0,    0,    0,    0,    0,    0,    0,    0,    0,    0,    0,    0,    0,    0,    0,    0,    0,    0,    0],
    [   0,    0,    0,    0,    0,    0,    0,    0,    0,    0,    0,    0,    0,    0,    0,    0,    0,    0,    0,    0]
  ]
}