{
  "largeur": 30,
  "hauteur": 40,
  "chipset": "marais2.png",
  "musique": "cc_viper_manor.ogg",
  "couche0": [
    [   8,    8,    8,    8,    8,    8,    8,    8,    8,    9,  241,  241,  241,  241,  304,  305,  306,  241,  241,  241,  241,  241,  241,  241,  241,  241,  241,  241,  241,  241],
    [  19,    8,    8,    8,    8,    8,   41,   38,   38,   39,  241,  241,  241,  241,  304,  305,  306,  241,  241,  241,  241,  241,  241,  241,  241,  241,  241,  241,  241,  241],
    [   8,  139,    8,    8,   41,   38,   39,   68,   68,   69,  241,  241,  241,  241,  304,  305,  306,  241,  241,  241,  241,  241,  241,  241,  241,  241,  241,  241,  241,  241],
    [   8,    8,    8,   41,   39,   68,   69,   98,   98,   99,  409,  241,  241,  241,  304,  305,  306,  241,  241,    5,  241,  241,  407,  408,  408,  408,  408,  409,  241,  241],
    [ 374,   19,   41,   39,   69,   98,   99,  128,  128,  129,  439,  241,  241,  241,  304,  305,  331,  276,  241,  241,  241,  241,  437,   13,  438,  438,  438,  451,  408,  409],
    [  41,   38,   39,   69,   99,  128,  129,  438,  391,  468,  469,  241,  241,  241,  334,  273,  305,  331,  276,  241,  241,  241,  437,  438,  438,  438,   43,   44,   45,  451],
    [   9,   68,   69,   99,  129,   19,  391,  468,  469,  241,  241,  241,  241,  241,  241,  303,  305,  305,  306,  241,  241,  241,  467,  393,  438,   43,   74,   74,   74,   45],
    [  39,   98,   99,  129,  391,  468,  469,  241,  241,  241,  241,  241,  241,  241,  241,  303,  271,  335,  336,    2,  241,  241,  241,  437,  438,  103,   74,   74,  105,  105],
    [  69,  128,  129,  391,  469,  241,  241,  241,    5,  241,  241,  241,  241,  241,  274,  333,  306,  241,  241,  241,  241,  241,  241,  467,  393,  438,  103,  104,  105,  438],
    [  99,  438,  391,  469,  241,  241,  241,  241,  241,  241,  241,  241,  241,  241,  304,  305,  306,  241,  241,  241,  241,  241,  241,  241,  467,  393,  438,  438,  438,  391],
    [ 129,  391,  469,  241,  241,  241,  241,  241,  241,  241,  241,  241,  241,  241,  304,  305,  306,  241,  241,  241,  241,  242,  241,  241,  241,  437,  438,   13,  438,  469],
    [ 468,  469,  241,  241,  241,  241,  241,  241,  241,  241,  241,  274,  275,  275,  333,  305,  331,  276,  241,  241,  241,  242,  241,  241,  241,  467,  468,  468,  469,  241],
    [ 241,  241,  241,  241,  241,  241,  241,  241,  241,  241,  274,  333,  305,  305,  305,  305,  305,  306,  241,  241,  241,  242,  241,  241,  241,  241,  241,  241,  241,  241],
    [ 241,  241,  241,  241,  241,  241,  241,  241,  241,  274,  333,  305,  305,  305,  305,  305,  305,  306,  241,  241,  242,  242,  241,  241,  241,  241,  241,  241,  241,  241],
    [ 241,  241,  241,  241,  241,  241,  241,  241,  241,  304,  305,  305,  305,  305,  305,  305,  271,  336,  241,  241,  242,  241,  241,  241,  241,  241,  241,  241,  241,  241],
    [ 241,  241,  241,  241,  241,  241,  241,  241,  241,  304,  305,  305,  305,  305,  305,  305,  336,  242,  241,  241,    5,  242,  241,  241,  241,  241,  241,  241,  241,  241],
    [ 241,  241,  241,  241,  241,  241,  241,  241,  274,  333,  305,  305,  305,  305,  271,  336,  242,  242,  241,  241,  241,  242,  241,  241,  241,  241,  241,  241,  241,  241],
    [ 241,  241,  241,  241,  241,  241,  241,  241,  303,  305,  305,  305,  305,  305,  306,  302,  302,  302,  241,  241,  242,  242,  241,  241,  241,  241,  241,    5,  241,  241],
    [ 241,  241,  241,  241,  241,  241,  241,  241,  304,  305,  305,  305,  305,  305,  306,  302,  302,  302,  241,  241,  242,  242,  241,  241,  241,  241,  241,  241,  241,  241],
    [ 241,  241,  241,  241,  241,  241,  241,  241,  304,  305,  305,  305,  305,  305,  306,  407,  408,  408,  408,  409,  242,  242,  241,  241,  241,  241,  241,  241,  241,  241],
    [ 241,  241,  241,  241,  241,  241,  274,  332,  333,  305,  305,  305,  305,  305,  306,  453,   19,  438,  438,  451,  409,  241,  241,  241,  241,  241,  241,  241,  241,  241],
    [ 241,  241,  241,  241,  241,  241,  303,  305,  305,  305,  305,  305,  305,  305,  317,   13,  438,  438,  438,  438,  451,  409,  241,  241,  241,  241,  241,  241,  241,  241],
    [ 241,  241,  241,  241,  241,  241,  303,  305,  305,  305,  305,  305,  305,  305,  347,  412,   16,  438,   19,  438,   13,  439,  241,  241,  241,  241,  241,  241,  241,  241],
    [ 241,  241,  241,  241,  241,  241,  303,  305,  305,  305,  305,  305,  305,  305,  305,  347,  348,  348,  348,  348,  412,  439,  241,  241,  241,  241,  241,  241,  241,  241],
    [ 241,  241,  241,    5,  241,  241,  304,  305,  305,  305,  305,  305,  305,  305,  305,  305,  305,  305,  305,  305,  317,  439,  241,  241,  241,  241,  241,  241,  241,  241],
    [ 241,  241,  241,  241,  241,  241,  334,  272,  272,  273,  305,  305,  305,  305,  305,  305,  305,  305,  305,  305,  347,  469,  241,  241,  241,  241,  241,  241,  241,  241],
    [ 241,  241,  241,  241,  241,  241,  241,  241,  241,  304,  305,  305,  305,  305,  305,  305,  305,  305,  305,  305,  331,  332,  332,  276,  241,  241,  241,  241,  241,  241],
    [ 241,  241,  241,  241,  241,  241,  241,  241,  241,  304,  305,  305,  305,  305,  305,  305,  305,  305,  305,  305,  305,  305,  305,  301,  241,  241,  241,  241,  241,  241],
    [   8,  241,  241,  241,  241,  241,  241,  241,  241,  304,  305,  305,  305,  305,  305,  305,  305,  305,  305,  305,  305,  305,  305,  301,  241,  241,  241,  241,  241,  241],
    [   8,    8,    8,    8,  241,  241,  241,  241,  241,  334,  335,  335,  273,  305,  305,  305,  305,  305,  305,  305,  305,  271,  335,  336,  241,  241,  241,  241,  241,  241],
    [   8,    8,    8,    8,    8,  241,  241,  241,  241,  241,  241,  241,  334,  272,  273,  305,  305,  305,  305,  305,  305,  301,  241,  241,  241,  241,  241,  241,  241,  241],
    [  13,    8,   19,    8,    8,  241,  241,  241,  241,  241,  241,  241,  241,  241,  303,  305,  305,  305,  305,  305,  305,  301,  241,  241,  241,    5,  241,  241,  241,    8],
    [   8,    8,    8,    8,   16,  241,  241,  241,  241,  241,  241,  241,  241,  241,  334,  335,  273,  305,  305,  305,  271,  336,  241,  241,  241,  241,  241,  241,  133,    8],
    [   8,    8,    8,    8,    8,  241,  241,  241,  241,  241,  241,  241,  241,  241,  241,  241,  304,  305,  305,  271,  336,  241,  241,  241,  241,  241,  241,  241,    8,    8],
    [  13,    8,    8,    8,    8,    8,  241,  241,  241,  241,    5,  241,  241,  241,  241,  241,  304,  305,  271,  336,  241,  241,  241,  241,  241,  241,  241,  241,    8,    8],
    [   8,    8,   16,    8,    8,    8,    8,  241,  241,  241,  241,  241,  241,  241,  241,  241,  304,  305,  306,  241,  241,  241,  241,  241,  241,  241,  241,  241,    8,   13],
    [  44,   45,    8,    8,    8,    8,    8,    8,  241,  241,  241,  241,  241,  241,  241,  241,  304,  305,  306,  241,  241,  241,  241,  241,  241,  241,  241,   19,    8,    8],
    [  74,   74,   45,    8,    8,    8,   16,    8,  302,  241,  241,  241,  241,  241,  241,  241,  304,  305,  306,  241,  241,  241,    8,    8,   13,    8,    8,   43,   44,   44],
    [  74,   74,   74,   45,    8,    8,    8,   13,    8,  302,  302,  302,  241,  241,  241,  241,  304,  305,  306,  241,  241,    8,  133,    8,    8,   16,   43,   74,   74,   74],
    [  74,   74,   74,   75,   19,    8,    8,    8,   13,    8,  302,  302,  241,  241,  241,  241,  304,  305,  306,  241,  241,   13,    8,    8,   19,   43,   74,   74,   74,   74]
  ],
  "couche1": [
    [   0,    0,    0,    0,    0,    0,    0,    0,    0,    0,    0,    0,    0,    0,    0,    0,    0,    0,    0,    0,    0,    0,    0,    0,    0,    0,    0,    0,    0,    0],
    [   0,    0,    0,    0,    0,    0,    0,    0,    0,    0,    0,    0,    0,    0,    0,    0,    0,    0,    0,    0,    0,    0,    0,    0,    0,    0,    0,    0,    0,    0],
    [   0,    0,    0,    0,    0,    0,    0,    0,    0,    0,    0,  235,  236,  237,    0,    0,    0,    0,    0,    0,    0,    0,    0,    0,    0,    0,    0,    0,    0,    0],
    [   0,    0,    0,    0,    0,    0,    0,    0,    0,    0,    0,  265,  266,  267,    0,    0,    0,    0,    0,    0,    0,    0,    0,    0,    0,    0,    0,    0,    0,    0],
    [   0,    0,    0,    0,    0,    0,    0,    0,    0,    0,    0,  295,  296,  297,    0,    0,    0,    0,    0,    0,    0,    0,    0,    0,    0,    0,    0,    0,    0,    0],
    [   0,    0,    0,    0,    0,    0,    0,    0,    0,    0,  235,  237,    0,    0,    0,    0,    0,    0,    0,    0,    0,    0,    0,    0,    0,    0,    0,    0,    0,    0],
    [   0,    0,    0,    0,    0,    0,    0,    0,    0,    0,  295,  297,    0,    0,    0,    0,    0,    0,    0,    0,    0,    0,    0,    0,    0,    0,    0,    0,    0,    0],
    [   0,    0,    0,    0,    0,    0,    0,    0,    0,    0,    0,    0,    0,    0,    0,    0,    0,    0,    0,    0,    0,    0,    0,    0,    0,    0,    0,    0,    0,    0],
    [   0,    0,    0,    0,    0,    0,    0,    0,    0,    0,    0,    0,    0,    0,    0,    0,    0,    0,    0,    0,    0,    0,    0,    0,    0,    0,    0,    0,    0,    0],
    [   0,    0,    0,    0,    0,    0,    0,    0,    0,    0,    0,    0,    0,    0,    0,    0,    0,    0,    0,  235,  236,  237,    0,    0,    0,    0,    0,    0,    0,    0],
    [   0,    0,    0,    0,    0,    0,    0,    0,    0,  235,  237,    0,    0,    0,    0,    0,    0,    0,    0,  265,  266,  267,    0,    0,    0,    0,    0,    0,    0,    0],
    [   0,    0,    0,    0,    0,    0,    0,    0,    0,  295,  297,    0,    0,    0,    0,    0,    0,    0,    0,  295,  296,  297,    0,    0,    0,    0,    0,    0,    0,    0],
    [   0,    0,    0,    0,    0,    0,    0,    0,    0,    0,    0,    0,    0,    0,    0,    0,    0,    0,    0,    0,    0,    0,    0,    0,    0,    0,    0,    0,    0,    0],
    [   0,    0,    0,    0,    0,    0,    0,    0,    0,    0,    0,    0,    0,    0,    0,    0,    0,    0,    0,    0,    0,    0,    0,    0,    0,    0,    0,    0,    0,    0],
    [   0,    0,    0,    0,    0,    0,    0,    0,    0,    0,    0,    0,    0,    0,    0,    0,    0,    0,    0,    0,    0,    0,    0,    0,    0,    0,    0,    0,    0,    0],
    [   0,    0,    0,    0,    0,    0,    0,    0,    0,    0,    0,    0,    0,    0,    0,    0,    0,    0,    0,    0,    0,    0,    0,    0,    0,    0,    0,    0,    0,    0],
    [   0,    0,  235,  236,  237,    0,    0,    0,    0,    0,    0,    0,    0,    0,    0,    0,    0,    0,    0,    0,    0,    0,    0,    0,    0,    0,    0,    0,    0,    0],
    [   0,    0,  265,  266,  267,    0,    0,    0,    0,    0,    0,    0,    0,    0,    0,    0,    0,    0,    0,    0,    0,    0,    0,    0,    0,    0,    0,    0,    0,    0],
    [   0,    0,  295,  296,  297,    0,    0,    0,    0,    0,    0,    0,    0,    0,    0,    0,    0,    0,    0,    0,    0,    0,    0,    0,    0,    0,    0,    0,    0,    0],
    [   0,    0,    0,    0,    0,    0,    0,    0,    0,    0,    0,    0,    0,    0,    0,    0,    0,    0,    0,    0,    0,    0,    0,    0,    0,    0,    0,    0,    0,    0],
    [   0,    0,    0,    0,    0,    0,    0,    0,    0,    0,    0,    0,    0,    0,    0,    0,    0,    0,    0,    0,    0,    0,    0,    0,  235,  237,    0,    0,    0,    0],
    [  42,    0,    0,    0,    0,    0,    0,    0,    0,    0,    0,    0,    0,    0,    0,    0,    0,    0,    0,    0,    0,    0,    0,    0,  295,  297,    0,    0,    0,    0],
    [  72,    0,    0,    0,    0,    0,    0,    0,    0,    0,    0,    0,    0,    0,    0,    0,    0,    0,    0,    0,    0,    0,    0,    0,    0,    0,    0,    0,    0,    0],
    [ 102,    0,    0,    0,    0,    0,    0,    0,    0,    0,    0,    0,    0,    0,    0,    0,    0,    0,    0,    0,    0,    0,    0,    0,    0,    0,  235,  236,  237,    0],
    [   0,    0,    0,    0,    0,    0,    0,    0,    0,    0,    0,    0,  235,  236,  237,    0,    0,    0,    0,    0,    0,    0,    0,    0,    0,    0,  265,  266,  267,    0],
    [   0,    0,    0,    0,    0,    0,    0,    0,    0,    0,    0,    0,  265,  266,  267,    0,    0,    0,  130,  131,  132,    0,    0,    0,    0,    0,  295,  296,  297,    0],
    [   0,    0,    0,    0,    0,    0,    0,    0,    0,    0,    0,    0,  295,  296,  297,    0,    0,    0,    0,    0,    0,    0,    0,    0,    0,    0,    0,    0,    0,    0],
    [  24,    0,    0,    0,    0,    0,  235,  237,    0,    0,    0,    0,    0,    0,    0,    0,    0,    0,    0,    0,    0,    0,    0,    0,    0,    0,    0,    0,    0,    0],
    [   0,   23,   23,   24,    0,    0,  295,  297,    0,    0,    0,    0,    0,    0,    0,    0,    0,    0,    0,    0,    0,    0,    0,  268,  269,    0,    0,    0,    0,    0],
    [   0,    0,    0,    0,   24,    0,    0,    0,    0,    0,    0,    0,    0,    0,    0,    0,    0,    0,    0,    0,    0,    0,    0,    0,    0,    0,    0,    0,    0,    0],
    [   0,    0,    0,    0,    0,   24,    0,    0,    0,    0,    0,    0,    0,    0,    0,    0,    0,    0,    0,    0,    0,    0,    0,    0,    0,    0,    0,    0,    0,   22],
    [   0,    0,    0,    0,    0,    9,    0,    0,    0,    0,    0,    0,    0,    0,    0,    0,    0,    0,    0,    0,    0,    0,    0,    0,    0,    0,    0,   22,   23,    0],
    [   0,    0,    0,    0,    0,    9,    0,    0,    0,    0,    0,    0,    0,    0,    0,    0,    0,    0,    0,    0,    0,    0,    0,    0,    0,    0,    0,    7,    0,    0],
    [ 370,  371,  372,  373,    0,    9,    0,    0,    0,    0,    0,    0,    0,    0,    0,    0,    0,    0,    0,    0,    0,    0,    0,    0,    0,    0,    0,    7,    0,    0],
    [   0,    0,    0,    0,    0,    0,   24,    0,    0,    0,    0,    0,    0,    0,    0,    0,    0,    0,    0,    0,    0,    0,    0,    0,    0,    0,    0,    7,    0,    0],
    [   0,    0,    0,    0,    0,    0,    0,   24,    0,    0,    0,    0,    0,    0,    0,    0,    0,    0,    0,    0,    0,    0,    0,    0,    0,    0,   22,   10,    0,    0],
    [   0,    0,    0,    0,    0,    0,    0,    0,   24,    0,    0,    0,    0,    0,    0,    0,    0,    0,    0,    0,    0,    0,   22,   23,   23,   23,   10,    0,    0,    0],
    [   0,    0,    0,    0,    0,    0,    0,    0,    9,    0,    0,    0,    0,    0,    0,    0,    0,    0,    0,    0,    0,   22,    0,    0,    0,    0,    0,    0,    0,    0],
    [   0,    0,    0,    0,    0,    0,    0,    0,    0,   24,    0,    0,    0,    0,    0,    0,    0,    0,    0,    0,   22,    0,    0,    0,    0,    0,    0,    0,    0,    0],
    [   0,    0,    0,    0,    0,    0,    0,    0,    0,    0,   23,   24,    0,    0,    0,    0,    0,    0,    0,    0,    7,    0,    0,    0,    0,    0,    0,    0,    0,    0]
  ],
  "couche2": [
    [   0,    0,    0,    0,    0,    0,    0,    0,    0,    0,    0,    0,    0,    0,    0,    0,    0,    0,    0,    0,    0,    0,    0,    0,    0,    0,    0,    0,    0,    0],
    [   0,    0,    0,    0,    0,    0,    0,    0,    0,    0,    0,    0,    0,    0,    0,    0,    0,    0,    0,    0,    0,    0,    0,    0,    0,    0,    0,    0,    0,    0],
    [   0,    0,    0,    0,    0,    0,    0,    0,    0,    0,    0,    0,    0,    0,    0,    0,    0,    0,    0,    0,    0,    0,    0,    0,    0,    0,    0,    0,    0,    0],
    [   0,    0,    0,    0,    0,    0,    0,    0,    0,    0,    0,    0,    0,    0,    0,    0,    0,    0,    0,    0,    0,    0,    0,    0,    0,    0,    0,    0,    0,    0],
    [   0,    0,    0,    0,    0,    0,    0,    0,    0,    0,    0,    0,    0,    0,    0,    0,    0,    0,    0,    0,    0,    0,    0,    0,    0,    0,    0,    0,    0,    0],
    [   0,    0,    0,    0,    0,    0,    0,    0,    0,    0,    0,    0,    0,    0,    0,    0,    0,    0,    0,    0,    0,    0,    0,    0,    0,    0,    0,    0,    0,    0],
    [   0,    0,    0,    0,    0,    0,    0,    0,    0,    0,    0,    0,    0,    0,    0,    0,    0,    0,    0,    0,    0,    0,    0,    0,    0,    0,    0,    0,    0,    0],
    [   0,    0,    0,    0,    0,    0,    0,    0,    0,    0,    0,    0,    0,    0,    0,    0,    0,    0,    0,    0,    0,    0,    0,    0,    0,    0,    0,    0,    0,    0],
    [   0,    0,    0,    0,    0,    0,    0,    0,    0,    0,    0,    0,    0,    0,    0,    0,    0,    0,    0,    0,    0,    0,    0,    0,    0,    0,    0,    0,    0,    0],
    [   0,    0,    0,    0,    0,    0,    0,    0,    0,    0,    0,    0,    0,    0,    0,    0,    0,    0,    0,    0,    0,    0,    0,    0,    0,    0,    0,    0,    0,    0],
    [   0,    0,    0,    0,    0,    0,    0,    0,    0,    0,    0,    0,    0,    0,    0,    0,    0,    0,    0,    0,    0,    0,    0,    0,    0,    0,    0,    0,    0,    0],
    [   0,    0,    0,    0,    0,    0,    0,    0,    0,    0,    0,    0,    0,    0,    0,    0,    0,    0,    0,    0,    0,    0,    0,    0,    0,    0,    0,    0,    0,    0],
    [   0,    0,    0,    0,    0,    0,    0,    0,    0,    0,    0,    0,    0,    0,    0,    0,    0,    0,    0,    0,    0,    0,    0,    0,    0,    0,    0,    0,    0,    0],
    [   0,    0,    0,    0,    0,    0,    0,    0,    0,    0,    0,    0,    0,    0,    0,    0,    0,    0,    0,    0,    0,    0,    0,    0,    0,    0,    0,    0,    0,    0],
    [   0,    0,    0,    0,    0,    0,    0,    0,    0,    0,    0,    0,    0,    0,    0,    0,    0,    0,    0,    0,    0,    0,    0,    0,    0,    0,    0,    0,    0,    0],
    [   0,    0,    0,    0,    0,    0,    0,    0,    0,    0,    0,    0,    0,    0,    0,    0,    0,    0,    0,    0,    0,    0,    0,    0,    0,    0,    0,    0,    0,    0],
    [   0,    0,    0,    0,    0,    0,    0,    0,    0,    0,    0,    0,    0,    0,    0,    0,    0,    0,    0,    0,    0,    0,    0,    0,    0,    0,    0,    0,    0,    0],
    [   0,    0,    0,    0,    0,    0,    0,    0,    0,    0,    0,    0,    0,    0,    0,    0,    0,    0,    0,    0,    0,    0,    0,    0,    0,    0,    0,    0,    0,    0],
    [   0,    0,    0,    0,    0,    0,    0,    0,    0,    0,    0,    0,    0,    0,    0,    0,    0,    0,    0,    0,    0,    0,    0,    0,    0,    0,    0,    0,    0,    0],
    [   0,    0,    0,    0,    0,    0,    0,    0,    0,    0,    0,    0,    0,    0,    0,    0,    0,    0,    0,    0,    0,    0,    0,    0,    0,    0,    0,    0,    0,    0],
    [   0,    0,    0,    0,    0,    0,    0,    0,    0,    0,    0,    0,    0,    0,    0,    0,    0,    0,    0,    0,    0,    0,    0,    0,    0,    0,    0,    0,    0,    0],
    [   0,    0,    0,    0,    0,    0,    0,    0,    0,    0,    0,    0,    0,    0,    0,    0,    0,    0,    0,    0,    0,    0,    0,    0,    0,    0,    0,    0,    0,    0],
    [   0,    0,    0,    0,    0,    0,    0,    0,    0,    0,    0,    0,    0,    0,    0,    0,    0,    0,    0,    0,    0,    0,    0,    0,    0,    0,    0,    0,    0,    0],
    [   0,    0,    0,    0,    0,    0,    0,    0,    0,    0,    0,    0,    0,    0,    0,    0,    0,    0,    0,    0,    0,    0,    0,    0,    0,    0,    0,    0,    0,    0],
    [   0,    0,    0,    0,    0,    0,    0,    0,    0,    0,    0,    0,    0,    0,    0,    0,    0,    0,    0,    0,    0,    0,    0,    0,    0,    0,    0,    0,    0,    0],
    [   0,    0,    0,    0,    0,    0,    0,    0,    0,    0,    0,    0,    0,    0,    0,    0,    0,    0,    0,    0,    0,    0,    0,    0,    0,    0,    0,    0,    0,    0],
    [   0,    0,    0,    0,    0,    0,    0,    0,    0,    0,    0,    0,    0,    0,    0,    0,    0,    0,    0,    0,    0,    0,    0,    0,    0,    0,    0,    0,    0,    0],
    [   0,    0,    0,    0,    0,    0,    0,    0,    0,    0,    0,    0,    0,    0,    0,    0,    0,    0,    0,    0,    0,    0,    0,  238,  239,    0,    0,    0,    0,    0],
    [   0,    0,    0,    0,    0,    0,    0,    0,    0,    0,    0,    0,    0,    0,    0,    0,    0,    0,    0,    0,    0,    0,    0,    0,    0,    0,    0,    0,    0,    0],
    [ 250,  251,  252,  253,    0,    0,    0,    0,    0,    0,    0,    0,    0,    0,    0,    0,    0,    0,    0,    0,    0,    0,    0,    0,    0,    0,    0,    0,    0,    0],
    [ 280,  281,  282,  283,    0,    0,    0,    0,    0,    0,    0,    0,    0,    0,    0,    0,    0,    0,    0,    0,    0,    0,    0,    0,    0,    0,    0,    0,    0,    0],
    [ 310,  311,  312,  313,    0,    0,    0,    0,    0,    0,    0,    0,    0,    0,    0,    0,    0,    0,    0,    0,    0,    0,    0,    0,    0,    0,    0,    0,    0,    0],
    [ 340,  341,  342,  343,    0,    0,    0,    0,    0,    0,    0,    0,    0,    0,    0,    0,    0,    0,    0,    0,    0,    0,    0,    0,    0,    0,    0,    0,    0,    0],
    [   0,    0,    0,    0,    0,    0,    0,    0,    0,    0,    0,    0,    0,    0,    0,    0,    0,    0,    0,    0,    0,    0,    0,    0,    0,    0,    0,    0,    0,    0],
    [   0,    0,    0,    0,    0,    0,    0,    0,    0,    0,    0,    0,    0,    0,    0,    0,    0,    0,    0,    0,    0,    0,    0,    0,    0,    0,    0,    0,    0,    0],
    [   0,    0,    0,    0,    0,    0,    0,    0,    0,    0,    0,    0,    0,    0,    0,    0,    0,    0,    0,    0,    0,    0,    0,    0,    0,    0,    0,    0,    0,    0],
    [   0,    0,    0,    0,    0,    0,    0,    0,    0,    0,    0,    0,    0,    0,    0,    0,    0,    0,    0,    0,    0,    0,    0,    0,    0,    0,    0,    0,    0,    0],
    [   0,    0,    0,    0,    0,    0,    0,    0,    0,    0,    0,    0,    0,    0,    0,    0,    0,    0,    0,    0,    0,    0,    0,    0,    0,    0,    0,    0,    0,    0],
    [   0,    0,    0,    0,    0,    0,    0,    0,    0,    0,    0,    0,    0,    0,    0,    0,    0,    0,    0,    0,    0,    0,    0,    0,    0,    0,    0,    0,    0,    0],
    [   0,    0,    0,    0,    0,    0,    0,    0,    0,    0,    0,    0,    0,    0,    0,    0,    0,    0,    0,    0,    0,    0,    0,    0,    0,    0,    0,    0,    0,    0]
  ]
}