{
  "murs": [
    [0, 0, 0, 0, 0, 0, 0, 0, 0, 0, 0, 0, 0, 0, 0],
    [0, 0, 0, 0, 0, 0, 0, 0, 0, 0, 0, 0, 0, 0, 0],
    [0, 0, 0, 0, 0, 0, 0, 1, 0, 0, 0, 0, 0, 0, 0],
    [0, 1, 1, 0, 0, 1, 1, 0, 1, 1, 0, 0, 1, 1, 0],
    [1, 0, 0, 1, 1, 0, 1, 0, 1, 0, 1, 1, 0, 0, 1],
    [1, 0, 0, 0, 0, 0, 0, 0, 0, 0, 0, 0, 0, 0, 1],
    [1, 0, 0, 0, 0, 0, 0, 0, 0, 0, 0, 0, 0, 0, 1],
    [1, 0, 0, 0, 0, 0, 0, 0, 0, 0, 0, 0, 0, 0, 1],
    [1, 0, 0, 0, 0, 0, 0, 0, 0, 0, 0, 0, 0, 0, 1],
    [1, 0, 0, 0, 0, 0, 0, 0, 0, 0, 0, 0, 0, 0, 1],
    [1, 0, 1, 1, 0, 0, 0, 0, 0, 1, 0, 1, 1, 0, 1],
    [1, 0, 0, 0, 0, 0, 0, 0, 0, 0, 0, 0, 0, 0, 1],
    [1, 0, 0, 0, 0, 0, 0, 0, 0, 1, 0, 0, 0, 0, 1],
    [1, 0, 0, 0, 0, 0, 0, 0, 0, 0, 0, 0, 0, 0, 1],
    [0, 1, 1, 1, 1, 1, 0, 0, 0, 1, 1, 1, 1, 1, 0]
  ],
  "ensemblesEvents": [
    {
      "x": 7,
      "y": 3,
      "events": [
        { "type": "TP", "xDst": 14, "yDst": 13, "carteDst": "Donjon1_salle4" }
      ]
    },
    {
      "x": 6,
      "y": 14,
      "events": [
        { "type": "TP", "xDst": 8, "yDst": 4, "carteDst": "Donjon1_Entree" }
      ]
    },
    {
      "x": 7,
      "y": 14,
      "events": [
        { "type": "TP", "xDst": 8, "yDst": 4, "carteDst": "Donjon1_Entree" }
      ]
    },
    {
      "x": 8,
      "y": 14,
      "events": [
        { "type": "TP", "xDst": 8, "yDst": 4, "carteDst": "Donjon1_Entree" }
      ]
    }
  ]
}