{
  "largeur": 30,
  "hauteur": 15,
  "chipset": "chipset175.png",
  "musique": "mystery3.ogg",
  "couche0": [
    [ 198,  254,  254,  254,  254,  254,  254,  254,  254,  254,  254,  254,  254,  254,  254,  254,  254,  254,  254,  254,  254,  254,  254,  254,  254,  254,  254,  254,  254,  197],
    [ 219,  299,  299,  299,  299,  299,  299,  299,  299,  299,  299,  299,  299,  299,  299,  299,  299,  299,  299,  299,  299,  299,  299,  299,  299,  299,  299,  299,  299,  217],
    [ 219,  299,  299,  299,  299,  299,  299,  299,  299,  299,  299,  299,  299,  299,  299,  299,  299,  299,  299,  299,  299,  299,  299,  299,  299,  299,  299,  299,  299,  217],
    [ 219,  335,  335,  335,  335,  335,  335,  335,  335,  335,  335,  335,  335,  335,  335,  335,  335,  335,  335,  335,  335,  335,  335,  335,  335,  335,  335,  335,  335,  253],
    [ 219,  509,  509,  509,  509,  509,  509,  509,  509,  510,  437,  437,  437,  508,  509,  509,  509,  509,  509,  509,  509,  509,  509,  509,  509,  509,  509,  509,  509,  299],
    [ 219,  509,  509,  509,  509,  509,  509,  509,  509,  509,  474,  436,  437,  544,  545,  545,  509,  509,  509,  509,  509,  509,  509,  438,  509,  509,  438,  509,  509,  299],
    [ 219,  509,  509,  509,  438,  509,  509,  509,  509,  438,  510,  437,  437,  437,  437,  437,  544,  509,  509,  509,  509,  438,  509,  509,  509,  509,  509,  438,  546,  335],
    [ 219,  509,  509,  509,  509,  509,  509,  438,  509,  509,  509,  473,  474,  437,  437,  437,  437,  508,  509,  509,  509,  509,  509,  509,  509,  509,  509,  510,  436,  472],
    [ 219,  509,  509,  509,  509,  545,  545,  509,  509,  509,  509,  509,  509,  474,  437,  436,  437,  508,  509,  438,  509,  545,  545,  509,  509,  438,  509,  510,  437,  508],
    [ 219,  509,  438,  509,  546,  437,  437,  508,  509,  509,  509,  509,  509,  510,  437,  437,  472,  509,  509,  509,  546,  437,  437,  544,  545,  545,  509,  510,  437,  544],
    [ 219,  509,  509,  510,  437,  436,  472,  509,  438,  509,  509,  438,  509,  509,  473,  473,  545,  545,  545,  509,  474,  437,  437,  437,  436,  437,  508,  509,  474,  181],
    [ 219,  509,  509,  509,  474,  437,  508,  509,  509,  509,  509,  509,  509,  509,  509,  546,  437,  437,  437,  508,  509,  473,  473,  473,  473,  473,  509,  509,  509,  217],
    [ 219,  509,  509,  438,  509,  473,  509,  509,  509,  509,  509,  509,  509,  545,  546,  437,  437,  437,  437,  508,  509,  509,  509,  509,  438,  509,  509,  509,  509,  217],
    [ 219,  509,  509,  509,  509,  509,  509,  438,  509,  509,  509,  509,  510,  437,  437,  436,  472,  473,  473,  436,  509,  509,  509,  509,  509,  509,  509,  509,  509,  217],
    [ 162,  182,  182,  182,  182,  182,  182,  182,  182,  182,  182,  182,  183,  472,  473,  474,  181,  182,  182,  182,  182,  182,  182,  182,  182,  182,  182,  182,  182,  161]
  ],
  "couche1": [
    [   0,    0,    0,    0,    0,    0,    0,    0,    0,    0,    0,    0,    0,    0,    0,    0,    0,    0,    0,    0,    0,    0,    0,    0,    0,    0,    0,    0,    0,    0],
    [   0,    0,    0,    0,   28,   29,   30,    0,  301,    0,    0,  302,    0,   25,   26,   27,    0,  301,    0,    0,    0,    0,    0,    0,    0,    0,  301,    0,    0,    0],
    [   0,    0,    0,    0,   64,   65,   66,    0,  337,    0,  303,  338,    0,   61,   62,   63,    0,  337,    0,    0,  281,  282,  281,  282,    0,    0,  337,    0,    0,    0],
    [   0,    0,    0,    0,  100,  101,  102,    0,    0,    0,  339,  339,    0,   97,   98,   99,    0,    0,    0,    0,  317,  318,  317,  318,    0,    0,    0,    0,    0,    0],
    [   0,  560,    0,    0,  136,  137,  138,    0,    0,    0,    0,    0,  199,  133,  134,  135,    0,    0,    0,    0,  353,  354,  353,  354,    0,    0,    0,    0,    0,    0],
    [   0,    0,    0,    0,  172,  173,  174,    0,    0,    0,    0,    0,  235,  169,  196,  171,  244,  245,  246,    0,    0,    0,    0,    0,    0,    0,    0,    0,    0,    0],
    [   0,    0,  386,  387,    0,    0,    0,    0,    0,    0,    0,    0,  238,  164,  165,  166,    0,    0,    0,    0,    0,    0,    0,    0,    0,    0,    0,    0,    0,    0],
    [   0,    0,    0,    0,    0,    0,    0,    0,    0,    0,    0,    0,    0,  200,  201,  202,    0,    0,    0,    0,    0,    0,    0,    0,    0,    0,    0,    0,    0,    0],
    [   0,  559,    0,    0,    0,    0,    0,    0,    0,    0,    0,    0,    0,    0,    0,    0,    0,    0,    0,    0,    0,    0,    0,    0,    0,    0,    0,    0,    0,    0],
    [   0,  137,    0,    0,    0,    0,    0,    0,    0,    0,    0,    0,    0,    0,    0,    0,    0,    0,    0,    0,    0,  203,  204,    0,    0,    0,    0,    0,    0,    0],
    [   0,  173,    0,    0,    0,    0,    0,    0,    0,  561,    0,    0,    0,    0,    0,    0,    0,    0,    0,    0,    0,  239,  240,    0,    0,    0,    0,    0,    0,    0],
    [   0,  313,    0,    0,    0,    0,    0,    0,    0,    0,    0,    0,    0,    0,    0,    0,    0,    0,    0,    0,    0,    0,    0,    0,    0,    0,    0,    0,    0,    0],
    [   0,  349,    0,    0,    0,    0,    0,    0,  206,  207,    0,    0,    0,    0,    0,    0,    0,  275,    0,    0,    0,    0,    0,    0,    0,    0,    0,    0,    0,    0],
    [   0,    0,    0,    0,    0,    0,    0,    0,  242,  243,    0,    0,    0,    0,    0,    0,    0,    0,    0,    0,    0,    0,    0,    0,    0,    0,    0,    0,    0,    0],
    [   0,    0,    0,    0,    0,    0,    0,    0,    0,    0,    0,    0,    0,    0,    0,    0,    0,    0,    0,    0,    0,    0,    0,    0,    0,    0,    0,    0,    0,    0]
  ],
  "couche2": [
    [   0,    0,    0,    0,    0,    0,    0,    0,    0,    0,    0,    0,    0,    0,    0,    0,    0,    0,    0,    0,    0,    0,    0,    0,    0,    0,    0,    0,    0,    0],
    [   0,    0,    0,    0,    0,    0,    0,    0,    0,    0,    0,    0,    0,    0,    0,    0,    0,    0,    0,    0,    0,    0,    0,    0,    0,    0,    0,    0,    0,    0],
    [   0,    0,    0,    0,    0,    0,    0,    0,    0,    0,    0,    0,    0,    0,    0,    0,    0,    0,    0,    0,    0,    0,    0,    0,    0,    0,    0,    0,    0,    0],
    [   0,    0,    0,    0,    0,    0,    0,    0,    0,    0,    0,    0,    0,    0,    0,    0,    0,    0,    0,    0,    0,    0,    0,    0,    0,    0,    0,    0,    0,    0],
    [   0,    0,    0,    0,    0,    0,    0,    0,    0,    0,    0,    0,    0,    0,    0,    0,  208,  209,  210,    0,    0,    0,    0,    0,    0,    0,    0,    0,    0,    0],
    [   0,    0,  350,  351,    0,    0,    0,    0,    0,    0,    0,    0,    0,    0,    0,    0,    0,    0,    0,    0,    0,    0,    0,    0,    0,    0,    0,    0,    0,    0],
    [   0,    0,    0,    0,    0,    0,    0,    0,    0,    0,    0,    0,    0,    0,    0,    0,    0,    0,    0,    0,    0,    0,    0,    0,    0,    0,    0,    0,    0,    0],
    [   0,    0,    0,    0,    0,    0,    0,    0,    0,    0,    0,    0,    0,    0,    0,    0,    0,    0,    0,    0,    0,    0,    0,    0,    0,    0,    0,    0,    0,    0],
    [   0,    0,    0,    0,    0,    0,    0,    0,    0,    0,    0,    0,    0,    0,    0,    0,    0,    0,    0,    0,    0,    0,    0,    0,    0,    0,    0,    0,    0,    0],
    [   0,    0,    0,    0,    0,    0,    0,    0,    0,    0,    0,    0,    0,    0,    0,    0,    0,    0,    0,    0,    0,    0,    0,    0,    0,    0,    0,    0,    0,    0],
    [   0,    0,    0,    0,    0,    0,    0,    0,    0,    0,    0,    0,    0,    0,    0,    0,    0,    0,    0,    0,    0,    0,    0,    0,    0,    0,    0,    0,    0,    0],
    [   0,    0,    0,    0,    0,    0,    0,    0,    0,    0,    0,    0,    0,    0,    0,    0,    0,  205,    0,    0,    0,    0,    0,    0,    0,    0,    0,    0,    0,    0],
    [   0,    0,    0,    0,    0,    0,    0,    0,    0,    0,    0,    0,    0,    0,    0,    0,    0,    0,    0,    0,    0,    0,    0,    0,    0,    0,    0,    0,    0,    0],
    [   0,    0,    0,    0,    0,    0,    0,    0,    0,    0,    0,    0,    0,    0,    0,    0,    0,    0,    0,    0,    0,    0,    0,    0,    0,    0,    0,    0,    0,    0],
    [   0,    0,    0,    0,    0,    0,    0,    0,    0,    0,    0,    0,    0,    0,    0,    0,    0,    0,    0,    0,    0,    0,    0,    0,    0,    0,    0,    0,    0,    0]
  ]
}