{
  "largeur": 15,
  "hauteur": 15,
  "chipset": "chipset175.png",
  "musique": "mystery3.ogg",
  "couche0": [
    [ 198,  257,  257,  257,  257,  257,  257,  257,  257,  257,  257,  257,  257,  257,  197],
    [ 222,  299,  299,  299,  299,  299,  299,  299,  299,  299,  299,  299,  299,  299,  220],
    [ 222,  299,  299,  299,  299,  299,  299,  299,  299,  299,  299,  299,  299,  299,  220],
    [ 222,  335,  335,  335,  335,  335,  335,  335,  335,  335,  335,  335,  335,  335,  220],
    [ 222,  509,  509,  509,  438,  509,  509,  509,  509,  509,  509,  509,  509,  509,  220],
    [ 222,  509,  438,  509,  509,  509,  509,  509,  509,  509,  509,  509,  438,  509,  220],
    [ 222,  509,  509,  509,  509,  509,  509,  436,  438,  509,  438,  509,  509,  509,  220],
    [ 222,  509,  509,  509,  509,  438,  509,  509,  436,  509,  509,  509,  509,  509,  220],
    [ 222,  509,  509,  509,  509,  509,  509,  509,  545,  509,  509,  509,  438,  509,  220],
    [ 222,  509,  509,  509,  509,  509,  509,  510,  437,  544,  545,  545,  545,  509,  220],
    [ 222,  509,  509,  509,  438,  509,  509,  546,  437,  437,  437,  437,  437,  508,  220],
    [ 222,  509,  509,  509,  509,  509,  546,  437,  437,  437,  437,  437,  472,  509,  220],
    [ 222,  509,  438,  509,  509,  510,  437,  437,  437,  437,  473,  473,  438,  509,  220],
    [ 222,  509,  509,  509,  509,  510,  437,  437,  437,  472,  438,  509,  509,  438,  220],
    [ 162,  185,  185,  185,  185,  186,  472,  473,  474,  184,  185,  185,  185,  185,  161]
  ],
  "couche1": [
    [   0,    0,    0,    0,    0,    0,    0,    0,    0,    0,    0,    0,    0,    0,    0],
    [   0,    0,  301,    0,    0,    0,   25,   26,   27,    0,    0,    0,  301,    0,    0],
    [   0,    0,  337,  281,  282,    0,   61,   62,   63,    0,  281,  282,  337,    0,    0],
    [   0,    0,    0,  317,  318,    0,   97,   98,   99,    0,  317,  318,    0,    0,    0],
    [   0,    0,    0,  353,  354,    0,  133,  134,  135,    0,  353,  354,    0,    0,    0],
    [   0,    0,    0,    0,    0,    0,  169,  170,  171,    0,    0,    0,    0,    0,    0],
    [   0,    0,    0,    0,    0,    0,    0,    0,    0,    0,    0,    0,    0,    0,    0],
    [   0,    0,    0,    0,    0,    0,    0,    0,    0,    0,    0,    0,    0,    0,    0],
    [   0,    0,    0,    0,    0,    0,    0,    0,    0,    0,    0,    0,    0,    0,    0],
    [   0,    0,    0,    0,    0,    0,    0,    0,    0,    0,    0,    0,    0,    0,    0],
    [   0,    0,  561,  266,    0,    0,    0,    0,    0,  564,    0,  164,  165,    0,    0],
    [   0,    0,    0,    0,    0,    0,    0,    0,    0,    0,    0,    0,    0,    0,    0],
    [   0,    0,    0,    0,    0,    0,    0,    0,    0,  559,    0,    0,    0,    0,    0],
    [   0,    0,    0,    0,    0,    0,    0,    0,    0,    0,    0,    0,    0,    0,    0],
    [   0,    0,    0,    0,    0,    0,    0,    0,    0,    0,    0,    0,    0,    0,    0]
  ],
  "couche2": [
    [   0,    0,    0,    0,    0,    0,    0,    0,    0,    0,    0,    0,    0,    0,    0],
    [   0,    0,    0,    0,    0,    0,    0,    0,    0,    0,    0,    0,    0,    0,    0],
    [   0,    0,    0,    0,    0,    0,    0,    0,    0,    0,    0,    0,    0,    0,    0],
    [   0,    0,    0,    0,    0,    0,    0,    0,    0,    0,    0,    0,    0,    0,    0],
    [   0,    0,    0,    0,    0,    0,    0,    0,    0,    0,    0,    0,    0,    0,    0],
    [   0,    0,    0,    0,    0,    0,    0,    0,    0,    0,    0,    0,    0,    0,    0],
    [   0,    0,    0,    0,    0,    0,    0,    0,    0,    0,    0,    0,    0,    0,    0],
    [   0,    0,    0,  416,    0,    0,    0,    0,    0,  419,    0,    0,    0,    0,    0],
    [   0,    0,    0,  452,    0,    0,    0,    0,    0,  455,    0,    0,    0,    0,    0],
    [   0,    0,    0,  488,    0,    0,    0,    0,    0,  491,    0,    0,    0,    0,    0],
    [   0,    0,    0,    0,    0,    0,    0,    0,    0,    0,    0,    0,    0,    0,    0],
    [   0,    0,    0,    0,    0,    0,    0,    0,    0,    0,    0,    0,    0,    0,    0],
    [   0,    0,    0,    0,    0,    0,    0,    0,    0,    0,    0,    0,    0,    0,    0],
    [   0,    0,    0,    0,    0,    0,    0,    0,    0,    0,    0,    0,    0,    0,    0],
    [   0,    0,    0,    0,    0,    0,    0,    0,    0,    0,    0,    0,    0,    0,    0]
  ]
}