{
  "largeur": 20,
  "hauteur": 15,
  "chipset": "chipset175.png",
  "musique": "mystery3.ogg",
  "couche0": [
    [ 198,  254,  254,  254,  254,  254,  254,  254,  254,  254,  254,  254,  254,  254,  254,  254,  254,  254,  254,  197],
    [ 219,  518,  518,  518,  518,  518,  518,  518,  518,  518,  518,  518,  518,  518,  518,  518,  518,  518,  518,  217],
    [ 219,  518,  518,  518,  518,  518,  518,  518,  518,  518,  518,  518,  518,  518,  518,  518,  518,  518,  518,  217],
    [ 255,  554,  554,  554,  554,  554,  554,  554,  554,  554,  554,  554,  554,  554,  554,  554,  554,  554,  554,  253],
    [ 518,  509,  509,  509,  509,  509,  509,  510,  437,  508,  509,  509,  509,  509,  509,  509,  509,  509,  509,  518],
    [ 518,  509,  509,  509,  509,  509,  509,  510,  437,  508,  509,  509,  509,  509,  509,  509,  509,  509,  509,  518],
    [ 554,  509,  509,  509,  509,  509,  509,  510,  437,  544,  509,  509,  509,  509,  509,  509,  509,  509,  509,  554],
    [ 477,  509,  509,  509,  509,  509,  509,  509,  474,  437,  508,  509,  509,  509,  509,  509,  509,  509,  509,  475],
    [ 513,  509,  509,  509,  509,  509,  509,  509,  509,  473,  509,  545,  509,  509,  509,  509,  509,  509,  509,  511],
    [ 549,  509,  509,  509,  509,  509,  509,  509,  509,  509,  546,  436,  508,  509,  509,  509,  509,  509,  509,  547],
    [ 183,  509,  509,  509,  509,  509,  509,  509,  509,  546,  437,  437,  508,  509,  509,  509,  509,  509,  509,  181],
    [ 219,  509,  509,  509,  509,  509,  509,  509,  510,  437,  437,  472,  509,  509,  509,  509,  509,  509,  509,  217],
    [ 219,  509,  509,  509,  509,  509,  509,  509,  546,  437,  437,  508,  509,  509,  509,  509,  509,  509,  509,  217],
    [ 219,  509,  509,  509,  509,  509,  509,  510,  437,  436,  437,  508,  509,  509,  509,  509,  509,  509,  509,  217],
    [ 162,  182,  182,  182,  182,  182,  182,  183,  437,  437,  437,  181,  182,  182,  182,  182,  182,  182,  182,  161]
  ],
  "couche1": [
    [   0,    0,    0,    0,    0,    0,    0,    0,    0,    0,    0,    0,    0,    0,    0,    0,    0,    0,    0,    0],
    [   0,    0,    0,    0,    0,    0,    0,   25,   26,   27,    0,    0,    0,    0,    0,    0,    0,    0,    0,    0],
    [   0,    0,    0,    0,  281,  282,    0,   61,   62,   63,    0,  281,  282,    0,    0,    0,    0,    0,    0,    0],
    [   0,    0,    0,    0,  317,  318,    0,   97,   98,   99,    0,  317,  318,    0,    0,    0,    0,    0,    0,    0],
    [   0,    0,    0,    0,  353,  354,    0,  133,  134,  135,    0,  353,  354,    0,    0,    0,    0,    0,    0,    0],
    [   0,    0,    0,    0,    0,    0,    0,  169,  170,  171,    0,    0,    0,    0,    0,  310,  311,  312,    0,    0],
    [   0,    0,    0,    0,    0,    0,    0,    0,    0,    0,    0,    0,    0,    0,    0,  346,  347,  348,    0,    0],
    [   0,    0,    0,    0,  560,    0,    0,    0,    0,    0,    0,    0,  559,    0,    0,  382,  383,  384,    0,    0],
    [   0,    0,    0,    0,    0,    0,    0,    0,    0,    0,    0,    0,    0,    0,    0,    0,    0,    0,    0,    0],
    [   0,    0,    0,    0,    0,    0,    0,    0,    0,    0,    0,    0,    0,    0,    0,    0,    0,    0,    0,    0],
    [   0,    0,    0,    0,    0,    0,    0,    0,    0,    0,    0,    0,    0,    0,    0,    0,    0,    0,  561,    0],
    [   0,    0,    0,    0,    0,    0,    0,    0,    0,    0,    0,    0,    0,    0,    0,    0,    0,    0,    0,    0],
    [   0,    0,    0,    0,    0,    0,    0,    0,    0,    0,    0,    0,    0,    0,    0,    0,    0,    0,    0,    0],
    [   0,    0,    0,    0,  208,  209,  210,    0,    0,    0,    0,    0,  205,  206,  207,    0,    0,    0,    0,    0],
    [   0,    0,    0,    0,    0,    0,    0,    0,    0,    0,    0,    0,    0,    0,    0,    0,    0,    0,    0,    0]
  ],
  "couche2": [
    [   0,    0,    0,    0,    0,    0,    0,    0,    0,    0,    0,    0,    0,    0,    0,    0,    0,    0,    0,    0],
    [   0,    0,    0,    0,    0,    0,    0,    0,    0,    0,    0,    0,    0,    0,    0,    0,    0,    0,    0,    0],
    [   0,    0,    0,    0,    0,    0,    0,    0,    0,    0,    0,    0,    0,    0,    0,    0,    0,    0,    0,    0],
    [   0,    0,    0,    0,    0,    0,    0,    0,    0,    0,    0,    0,    0,    0,    0,    0,    0,    0,    0,    0],
    [   0,    0,    0,    0,    0,    0,    0,    0,    0,    0,    0,    0,    0,    0,    0,    0,    0,    0,    0,    0],
    [   0,    0,    0,    0,    0,    0,    0,    0,    0,    0,    0,    0,    0,    0,    0,    0,    0,    0,    0,    0],
    [   0,    0,    0,    0,    0,    0,    0,    0,    0,    0,    0,    0,    0,    0,    0,    0,    0,    0,    0,    0],
    [   0,    0,    0,    0,    0,    0,    0,    0,    0,    0,    0,    0,    0,    0,    0,    0,    0,    0,    0,    0],
    [   0,    0,    0,    0,    0,    0,    0,    0,    0,    0,    0,    0,    0,    0,    0,    0,    0,    0,    0,    0],
    [   0,    0,    0,    0,    0,    0,    0,    0,    0,    0,    0,    0,    0,    0,    0,    0,    0,    0,    0,    0],
    [   0,    0,    0,    0,    0,    0,    0,    0,    0,    0,    0,    0,    0,    0,    0,    0,    0,    0,    0,    0],
    [   0,    0,    0,  418,    0,    0,    0,  417,    0,    0,    0,  418,    0,    0,    0,  418,    0,    0,    0,    0],
    [   0,    0,    0,  454,    0,    0,    0,  453,    0,    0,    0,  454,    0,    0,    0,  454,    0,    0,    0,    0],
    [   0,    0,    0,  490,    0,    0,    0,  489,    0,    0,    0,  490,    0,    0,    0,  490,    0,    0,    0,    0],
    [   0,    0,    0,    0,    0,    0,    0,    0,    0,    0,    0,    0,    0,    0,    0,    0,    0,    0,    0,    0]
  ]
}