{
  "largeur": 50,
  "hauteur": 31,
  "chipset": "chipset5c.png",
  "musique": "chapt1medfill.ogg",
  "couche0": [
    [ 272,  272,  272,  272,  272,  272,  272,  272,  272,  272,  272,  272,  272,  272,  272,  272,  272,  272,  272,  272,  272,  272,  272,  272,  272,  272,  302,  421,  422,  423,  272,  272,  272,  272,  272,  272,  272,  272,  272,  272,  272,  272,  272,  272,  272,  272,  272,  272,  272,  272],
    [ 272,  272,  272,  272,  272,  272,  272,  272,  272,  272,  272,  272,  272,  272,  272,  272,  272,  272,  272,  272,  272,  272,   68,  272,  128,  272,  391,  422,  422,  423,  272,  272,  247,  272,  272,  272,  272,  272,  272,  272,  272,  272,  272,  272,  272,  272,  272,  272,  272,  272],
    [ 272,  272,  272,  272,  272,  272,  272,  272,  272,  272,  272,  272,  272,  272,  272,  272,  272,  272,  272,  272,  272,  272,  272,  272,  272,  272,  421,  422,  422,  423,  272,  272,  272,  272,  272,  272,  272,  272,  272,  272,  272,  272,  272,  272,  272,  272,  272,  272,  272,  272],
    [ 272,  272,  272,  272,  272,  272,  272,  272,  272,  272,  272,  272,  272,  272,  272,  272,  272,  272,  272,  272,  272,  272,  272,  272,  272,  391,  422,  422,  422,  453,  272,  272,  272,  272,  272,  272,  272,  272,  272,  272,  272,  272,  272,  272,  272,  272,  272,  272,  272,  272],
    [ 272,  272,  272,  272,  272,  272,  272,  272,  272,  272,  272,  272,  272,  272,  272,  272,  272,  272,  272,  272,  272,  272,  272,  272,  272,  421,  422,  422,  423,  302,  272,  272,  272,  272,  272,  272,  272,  272,  272,  272,  272,  272,  272,  272,  302,  302,  302,  302,  302,  302],
    [ 272,  272,  272,  272,  272,  272,  272,  272,  272,  272,  272,  272,  272,  272,  272,  272,  272,  272,  272,  302,  302,  302,  302,  302,  391,  422,  422,  422,  423,  302,  272,  272,  272,  272,  272,  272,  272,  272,  272,  272,  272,  272,  272,  272,  302,  302,  302,  302,  302,  302],
    [ 272,  272,  272,  272,  272,  272,  272,  272,  272,  272,  272,  272,  272,  272,  272,  272,  272,  272,  272,  302,  247,  302,  302,  302,  421,  422,  422,  422,  453,  302,  302,  302,  302,  302,  302,  302,  302,  302,  302,  302,  302,  302,  302,  302,  302,  302,  302,  302,  302,  302],
    [ 272,  272,  272,  272,  272,  272,  272,  272,  272,  272,  272,  272,  272,  272,  272,  272,   68,  272,  272,  302,  302,  302,  302,  391,  422,  422,  422,  453,  302,  302,  302,  302,  302,  302,   68,  302,  302,  302,  302,  302,  302,  302,  302,  302,  302,  302,  302,  302,  302,  302],
    [ 302,  302,  302,  302,  302,  302,  302,  302,  302,  302,  302,  302,  302,  302,  302,  302,  302,  302,  302,  302,  302,  302,  302,  421,  422,  422,  423,  302,  302,  302,  302,  302,  302,  302,  302,  302,  302,  302,  302,  302,  302,  302,  302,  302,  302,  302,  302,  302,  302,  302],
    [ 302,  302,  302,  302,  302,  302,  302,  302,  302,  302,  302,  302,  302,  302,  302,  302,  302,  302,  302,  302,  302,  391,  392,  422,  422,  422,  453,  302,  302,  302,  302,  302,  302,  302,  302,  302,  302,  302,  302,  302,  302,  302,  302,  302,  302,  302,  302,  302,  302,  302],
    [ 302,  302,  302,  302,  302,  302,  302,  302,  272,  302,  302,  302,  302,  302,  302,  302,  302,  302,  302,  302,  302,  421,  422,  422,  422,  453,  302,  302,  302,  374,  374,  247,  374,  374,  302,  302,  302,  302,  302,  302,  302,  302,  302,  302,  302,  302,  302,  302,  302,  302],
    [ 302,  302,  302,  302,  302,  302,  302,  302,  302,  302,  302,  302,  302,  302,  302,  302,  302,  302,  302,  302,  302,  421,  422,  422,  423,  302,  302,  302,  302,  302,  374,  374,  374,  374,  374,  302,  302,  302,  302,  302,  302,  302,  302,  302,  302,  302,  302,  302,  302,  302],
    [ 302,  302,  302,  302,  302,  302,  302,  302,  247,  302,  302,  302,  302,  302,  302,  302,  302,  302,  302,  302,  302,  421,  422,  422,  423,  302,  302,  302,  302,  302,  374,  374,  374,  374,  374,  302,  302,  302,  302,  302,  302,  302,  302,  302,  302,  302,  302,  302,  302,  302],
    [ 302,  302,  302,  302,  302,  302,  302,  302,  302,  302,  302,  302,  302,  302,  302,  302,  302,  302,  302,  302,  391,  422,  422,  422,  423,  302,  272,  272,  272,  272,  374,  374,  247,  374,  374,  302,  302,   68,  302,  302,  302,  302,  302,  302,  302,  302,  302,  302,  302,  302],
    [ 302,  302,  302,  302,  302,  302,  302,  302,   68,  302,  302,  302,  302,  302,  302,  302,  302,  302,  391,  392,  422,  422,  422,  422,  422,  393,  272,  272,  272,  272,  374,  374,  374,  374,  302,  302,  302,  302,  302,  302,  302,  302,  302,  302,  302,  302,  302,  302,  302,  302],
    [ 302,  302,  302,  302,  302,  302,  302,  302,  302,  302,  302,  302,  302,  302,  302,  302,  391,  392,  422,  422,  422,  422,  422,  422,  422,  423,  272,  272,  272,  272,  272,  272,  272,  302,  302,  302,  302,  302,  302,  302,  302,  302,  302,  302,  302,  302,  302,  302,  302,  302],
    [  68,  302,  302,  302,  247,  302,  302,  272,  272,  272,  272,  272,  272,  247,  272,  272,  421,  422,  422,  422,  422,  422,  422,  422,  422,  422,  392,  392,  392,  393,  272,  272,  272,  302,  302,  302,  302,  302,  302,  247,  302,  302,  302,  302,  302,  248,  248,  248,  302,  302],
    [ 302,  302,  302,  302,  302,  302,  302,  272,  272,  247,  272,  272,  272,  272,  391,  392,  422,  422,  422,  422,  422,  422,  422,  422,  422,  422,  422,  422,  422,  423,  272,  272,  272,  302,  302,  302,  302,  302,  302,  302,  302,  302,  302,  302,  302,  248,  248,  248,  248,  302],
    [ 392,  392,  392,  392,  392,  392,  393,  362,  272,  272,  272,  391,  392,  392,  422,  422,  422,  422,  422,  422,  422,  452,  452,  452,  452,  422,  422,  422,  422,  422,  392,  392,  392,  393,  302,  302,  302,  302,  302,  302,  302,  302,  302,  302,  302,  247,  248,  248,  248,  302],
    [ 422,  422,  422,  422,  422,  422,  422,  393,  272,  272,  391,  422,  422,  422,  422,  422,  422,  452,  452,  452,  453,  302,  302,  302,  302,  451,  452,  422,  422,  422,  422,  422,  422,  423,  302,  302,  302,  302,  302,  302,  302,  391,  393,  302,  302,  302,  248,  248,  247,  302],
    [ 452,  452,  452,  422,  422,  422,  422,  422,  392,  392,  422,  422,  422,  452,  452,  452,  453,  302,  302,  302,  302,  302,  302,  302,  247,  302,  272,  451,  452,  422,  422,  422,  422,  422,  393,  272,   68,  272,  272,  391,  392,  422,  422,  392,  393,  302,  302,  302,  302,  302],
    [ 302,  302,  302,  451,  452,  452,  422,  422,  422,  422,  422,  452,  453,  272,  272,  272,  272,  302,  302,  302,  247,  302,  302,  302,  302,  302,  272,  272,  272,  451,  452,  452,  422,  422,  423,  272,  272,  391,  392,  422,  422,  422,  422,  422,  422,  392,  392,  392,  392,  392],
    [ 302,  302,  302,  302,  302,  302,  451,  452,  452,  452,  453,  272,  272,  272,  272,  272,  272,  302,  302,  302,  302,  302,  302,  302,  302,  302,  272,  272,  272,  272,  272,  272,  421,  422,  422,  392,  392,  422,  422,  422,  422,  422,  422,  422,  422,  422,  422,  422,  422,  422],
    [ 302,  248,  247,  302,  302,  302,  302,  272,  272,  272,  272,  272,  272,  272,  272,  272,  272,  302,  302,  302,  302,  302,  302,  302,  302,  302,  272,  272,  272,  272,  272,  272,  451,  452,  422,  422,  422,  422,  422,  422,  422,  422,  452,  452,  452,  452,  452,  452,  452,  452],
    [  68,  302,  302,  302,  302,  302,  302,  272,  272,  272,  272,  272,  272,  272,  272,  272,  272,  302,  302,  302,  302,  302,  302,  302,  302,  302,  272,  272,  272,  272,  272,  272,  272,  272,  421,  422,  422,  422,  422,  452,  452,  453,  302,  302,  302,  302,  302,  302,  302,  302],
    [ 302,  302,  302,  302,  302,  302,  302,  272,  272,  247,  272,  272,  272,  272,  272,  272,  272,  302,  302,  302,  302,  302,  302,  302,  302,  302,  272,  272,  272,  272,  272,  272,  272,  272,  451,  452,  452,  452,  453,  272,  302,  302,  302,  302,  302,  302,  247,  302,  302,  302],
    [ 302,  302,  302,  302,  302,  302,  302,  302,  302,  302,  302,  302,  302,  302,  302,  302,  302,  302,  302,  302,  302,  302,  302,  302,  302,  302,  272,  272,  272,  272,  272,  272,  272,  272,  272,  272,  272,  272,  272,  272,  302,  302,  302,  302,  302,  302,  302,  302,  302,  302],
    [ 302,  247,  302,  302,  302,  302,  302,  302,  302,  302,  302,  302,  302,  302,  302,  302,  302,  302,  302,  302,  302,  302,  302,  302,  302,  302,  302,  302,  302,  272,  272,  272,  272,  272,  247,  272,  272,  272,  272,  272,  302,   68,  302,  302,  302,  302,  302,  302,  302,  302],
    [ 302,  302,  302,  302,  302,  302,  302,   68,  302,  302,  302,  302,  302,  302,  302,  302,  302,  302,  302,  302,  302,  302,  302,  302,  302,  302,  302,  302,  302,  272,  272,  272,  272,  272,  272,  272,  272,  272,  272,  272,  302,  302,  302,  302,  302,  302,  302,  302,   68,  302],
    [ 302,  302,  302,  302,  302,  302,  302,  302,  302,  302,  302,  302,  302,  302,  302,  302,  302,  302,  302,  302,  302,  302,  302,  302,  302,  302,  302,  302,  302,  272,  272,  272,  272,  272,  272,  272,  272,  272,  272,  272,  302,  302,  302,  302,  302,  302,  302,  302,  302,  302],
    [ 302,  302,  302,  302,  302,  302,  302,  302,  302,  302,  302,  302,  302,  302,  302,  302,  302,  302,  302,  302,  302,  302,  302,  302,  302,  302,  302,  302,  302,  272,  272,  272,  272,  272,  272,  272,  272,  272,  272,  272,  302,  302,  302,  302,  302,  302,  302,  302,  302,  302]
  ],
  "couche1": [
    [ 234,  234,  234,  234,  234,  234,  234,  234,  234,  234,  234,  234,  234,  234,  234,  234,  234,    0,    0,    0,    0,    0,    0,    0,    0,    0,    0,    0,    0,    0,    0,    0,    0,    0,    0,  233,  233,  233,  233,  234,  234,  234,  234,  234,  234,  234,  234,  234,  234,  234],
    [ 234,  234,  234,  234,  234,  234,  234,  234,  234,  234,  234,  234,  234,  234,  234,  234,  234,    0,    0,    0,    0,    0,    0,    0,    0,    0,    0,    0,    0,    0,    0,    0,    0,    0,    0,  233,  233,  233,  233,  234,  234,  234,  234,  234,  234,  234,  234,  234,  234,  234],
    [ 234,  234,  234,  234,  234,  234,  234,  234,  234,  234,  234,  234,  234,  234,  234,  234,  234,    0,    0,    0,    0,    0,    0,    0,    0,    0,    0,    0,    0,    0,    0,    0,    0,    0,    0,  233,  233,  233,  233,  234,  234,  234,  234,  234,  234,  234,  234,  234,  234,  234],
    [ 234,  234,  234,  234,  234,  234,  234,  234,  234,  234,  234,  234,  234,  234,  234,  234,  234,    0,    0,    0,    0,    0,    0,    0,    0,    0,    0,    0,    0,    0,    0,    0,    0,    0,    0,  233,  233,  233,  233,  234,  234,  234,  234,  234,  234,  234,  234,  234,  234,  234],
    [ 234,  234,  234,  234,  234,  234,  234,  234,  234,  234,  234,  234,  234,  234,  234,  234,  234,    0,    0,    0,    0,    0,    0,    0,    0,    0,    0,    0,    0,    0,    0,    0,    0,    0,    0,  233,  233,  233,  233,  233,  233,  234,  234,  234,  234,  234,  234,  234,  234,  234],
    [ 234,  234,  234,  234,  234,  234,  234,  234,  234,  234,  234,  234,  234,    0,    0,    0,    0,    0,    0,    0,    0,    0,    0,    0,    0,    0,    0,    0,    0,    0,    0,    0,    0,    0,    0,    0,    0,    0,  233,  233,  233,  234,  234,  234,  234,  234,  234,  234,  234,  234],
    [ 234,  234,  234,  234,  234,  234,  234,  234,  234,  234,  234,  234,  234,    0,    0,    0,    0,    0,    0,    0,    0,    0,    0,    0,    0,    0,    0,    0,    0,    0,    0,    0,    0,    0,    0,    0,    0,    0,  233,  233,  233,  234,  234,  234,  234,  234,  234,  234,  234,  234],
    [ 234,  234,  234,  234,  234,  234,  234,  234,  234,  234,    0,    0,    0,    0,    0,    0,    0,    0,    0,    0,    0,    0,    0,    0,    0,    0,    0,    0,    0,    0,    0,    0,    0,    0,    0,    0,    0,    0,  233,  233,  233,  233,  233,  233,  233,  234,  234,  234,  234,  234],
    [ 234,  234,  234,  234,  234,  234,    0,    0,    0,    0,    0,    0,    0,    0,    0,    0,    0,    0,    0,    0,    0,    0,    0,    0,    0,    0,    0,    0,    0,    0,    0,    0,    0,    0,    0,    0,    0,    0,  233,  233,  233,  234,  234,  233,  233,  233,  233,  233,  233,  233],
    [ 234,  234,  234,  234,    0,    0,    0,    0,    0,    0,    0,    0,    0,    0,    0,    0,    0,    0,    0,    0,    0,    0,    0,    0,    0,    0,    0,    0,    0,    0,    0,    0,    0,    0,    0,    0,    0,    0,    0,    0,    0,    0,    0,  233,  233,  233,  233,  233,  233,  233],
    [ 234,  234,  234,  234,    0,    0,    0,    0,    0,    0,    0,    0,    0,    0,    0,    0,    0,    0,    0,  447,    0,    0,    0,    0,    0,    0,    0,    0,    0,    0,    0,    0,    0,    0,    0,    0,    0,    0,    0,    0,    0,    0,    0,  233,  233,  233,  233,  233,  233,  233],
    [ 234,  234,  234,  234,    0,    0,    0,    0,    0,    0,    0,    0,    0,    0,    0,    0,    0,    0,    0,    0,    0,    0,    0,    0,    0,    0,    0,    0,    0,    0,    0,    0,    0,    0,    0,    0,    0,    0,    0,    0,    0,    0,    0,  233,  233,  233,  233,  233,  233,  233],
    [ 234,  234,  234,  234,    0,    0,    0,    0,    0,    0,    0,    0,  447,    0,    0,    0,    0,    0,    0,    0,    0,    0,    0,    0,    0,    0,    0,    0,    0,    0,    0,    0,    0,    0,    0,    0,    0,    0,    0,    0,    0,    0,    0,  233,  233,  233,  233,    0,    0,    0],
    [ 234,  234,  234,  234,    0,    0,    0,    0,    0,    0,    0,    0,    0,    0,    0,    0,    0,    0,    0,    0,    0,    0,    0,    0,    0,    0,    0,    0,    0,    0,    0,    0,    0,    0,    0,    0,    0,    0,    0,    0,    0,    0,    0,    0,    0,    0,    0,    0,    0,    0],
    [   0,    0,    0,    0,    0,    0,    0,    0,    0,    0,    0,    0,    0,    0,    0,    0,    0,    0,    0,    0,    0,    0,    0,    0,    0,    0,    0,    0,    0,    0,    0,    0,    0,    0,    0,    0,    0,    0,    0,    0,    0,    0,    0,    0,    0,    0,    0,    0,    0,    0],
    [   0,    0,    0,    0,    0,    0,    0,    0,    0,    0,    0,    0,    0,    0,    0,    0,    0,    0,    0,    0,    0,    0,    0,    0,    0,    0,    0,    0,    0,    0,    0,    0,    0,    0,    0,    0,    0,    0,    0,    0,    0,    0,    0,    0,    0,    0,    0,    0,    0,    0],
    [   0,    0,    0,    0,    0,    0,    0,    0,    0,    0,    0,    0,    0,    0,    0,    0,    0,    0,    0,    0,    0,    0,  415,    0,    0,    0,    0,    0,    0,    0,    0,    0,    0,    0,    0,    0,    0,    0,    0,    0,    0,    0,    0,    0,    0,    0,    0,    0,    0,    0],
    [   0,    0,    0,    0,    0,    0,    0,    0,    0,    0,    0,    0,    0,    0,    0,    0,    0,    0,    0,    0,    0,    0,    0,    0,    0,    0,    0,    0,    0,    0,    0,    0,    0,  447,    0,    0,    0,    0,    0,    0,    0,    0,    0,    0,    0,    0,    0,    0,    0,    0],
    [   0,    0,    0,    0,    0,    0,    0,    0,    0,    0,    0,    0,    0,    0,    0,    0,    0,    0,    0,    0,    0,    0,    0,    0,    0,    0,    0,    0,    0,    0,    0,    0,    0,    0,    0,    0,    0,    0,    0,    0,    0,    0,    0,    0,    0,    0,    0,    0,    0,    0],
    [   0,    0,    0,    0,    0,    0,    0,    0,    0,    0,    0,    0,    0,    0,    0,    0,    0,    0,    0,    0,    0,    0,    0,    0,    0,    0,    0,    0,    0,    0,    0,    0,    0,    0,    0,    0,    0,    0,    0,    0,    0,    0,    0,    0,    0,    0,    0,    0,    0,    0],
    [   0,    0,    0,    0,    0,    0,    0,    0,    0,    0,    0,    0,    0,    0,    0,    0,    0,    0,    0,    0,    0,    0,    0,    0,    0,    0,    0,    0,    0,    0,    0,    0,    0,    0,    0,    0,    0,    0,    0,    0,    0,    0,    0,    0,    0,    0,    0,    0,    0,    0],
    [   0,    0,    0,    0,    0,    0,    0,    0,    0,    0,    0,    0,    0,    0,    0,    0,    0,    0,    0,    0,    0,    0,    0,    0,    0,    0,    0,    0,    0,    0,    0,    0,    0,    0,    0,    0,    0,    0,    0,    0,    0,    0,    0,    0,    0,    0,    0,    0,    0,    0],
    [   0,    0,    0,    0,    0,    0,    0,    0,    0,    0,    0,    0,    0,    0,    0,    0,    0,    0,    0,    0,    0,    0,    0,    0,    0,    0,    0,    0,    0,    0,    0,    0,    0,    0,    0,    0,    0,    0,    0,    0,    0,    0,    0,    0,    0,    0,    0,    0,    0,    0],
    [   0,    0,    0,    0,    0,    0,    0,    0,    0,    0,    0,    0,    0,    0,    0,  447,    0,    0,    0,    0,    0,    0,  234,  234,  234,    0,    0,    0,    0,    0,    0,    0,    0,    0,    0,    0,    0,    0,    0,    0,    0,    0,    0,    0,    0,    0,    0,    0,    0,    0],
    [   0,    0,    0,    0,    0,    0,    0,    0,    0,    0,    0,    0,    0,    0,    0,    0,    0,    0,    0,    0,    0,  234,  234,  234,  234,    0,    0,    0,    0,    0,    0,    0,    0,    0,    0,    0,    0,    0,    0,    0,    0,    0,    0,    0,    0,    0,    0,    0,    0,    0],
    [   0,    0,    0,    0,  447,    0,    0,    0,    0,    0,    0,    0,    0,    0,    0,    0,    0,    0,    0,    0,  234,  234,  234,  234,  234,  234,  234,    0,    0,    0,    0,    0,    0,    0,    0,    0,    0,    0,    0,    0,    0,    0,    0,    0,    0,    0,    0,    0,    0,    0],
    [   0,    0,    0,    0,    0,    0,    0,    0,    0,    0,    0,    0,    0,    0,    0,    0,    0,    0,  234,  234,  234,  234,  234,  234,  234,  234,  234,  234,    0,    0,    0,    0,    0,    0,    0,    0,    0,    0,    0,    0,    0,    0,    0,    0,    0,    0,    0,    0,    0,    0],
    [   0,    0,    0,    0,    0,    0,    0,    0,    0,    0,    0,    0,    0,    0,  234,  234,  234,  234,  234,  234,  234,  234,  234,  234,  234,  234,  234,  234,  234,  234,    0,    0,    0,    0,    0,    0,    0,  295,  296,  297,  298,    0,    0,    0,  447,    0,    0,    0,    0,    0],
    [   0,    0,    0,    0,    0,    0,    0,    0,    0,    0,    0,  234,  234,  234,  234,  234,  234,  234,  234,  234,  234,  234,  234,  234,  234,  234,  234,  234,  234,  234,    0,    0,    0,    0,    0,    0,    0,    0,    0,    0,    0,    0,    0,    0,    0,    0,    0,    0,    0,    0],
    [   0,    0,    0,    0,    0,    0,    0,    0,    0,    0,    0,  234,  234,  234,  234,  234,  234,  234,  234,  234,  234,  234,  234,  234,  234,  234,  234,  234,  234,  234,  234,  234,    0,    0,    0,    0,    0,    0,    0,    0,    0,    0,    0,    0,    0,    0,    0,    0,    0,    0],
    [   0,    0,    0,    0,    0,    0,    0,    0,    0,    0,    0,  234,  234,  234,  234,  234,  234,  234,  234,  234,  234,  234,  234,  234,  234,  234,  234,  234,  234,  234,  234,  234,    0,    0,    0,    0,    0,    0,    0,    0,    0,    0,    0,    0,    0,  295,  296,  297,  298,    0]
  ],
  "couche2": [
    [   0,    0,    0,    0,    0,    0,    0,    0,    0,    0,    0,    0,    0,    0,    0,    0,    0,    0,    0,    0,    0,    0,    0,    0,    0,    0,    0,    0,    0,    0,    0,    0,    0,    0,    0,    0,    0,    0,    0,    0,    0,    0,    0,    0,    0,    0,    0,    0,    0,    0],
    [   0,    0,    0,    0,    0,    0,    0,    0,    0,    0,    0,    0,    0,    0,    0,    0,    0,    0,    0,    0,    0,    0,    0,    0,    0,    0,    0,    0,    0,    0,    0,    0,    0,    0,    0,    0,    0,    0,    0,    0,    0,    0,    0,    0,    0,    0,    0,    0,    0,    0],
    [   0,    0,    0,    0,    0,    0,    0,    0,    0,    0,    0,    0,    0,    0,    0,    0,    0,    0,    0,    0,    0,    0,    0,    0,    0,    0,    0,    0,    0,    0,    0,    0,    0,    0,    0,    0,    0,    0,    0,    0,    0,    0,    0,    0,    0,    0,    0,    0,    0,    0],
    [   0,    0,    0,    0,    0,    0,    0,    0,    0,    0,    0,    0,    0,    0,    0,    0,    0,    0,    0,    0,    0,    0,    0,    0,    0,    0,    0,    0,    0,    0,    0,    0,    0,    0,    0,    0,    0,    0,    0,    0,    0,    0,    0,    0,    0,    0,    0,    0,    0,    0],
    [   0,    0,    0,    0,    0,    0,    0,    0,    0,    0,    0,    0,    0,    0,    0,    0,    0,    0,    0,    0,    0,    0,    0,    0,    0,    0,    0,    0,    0,    0,    0,    0,    0,    0,    0,    0,    0,    0,    0,    0,    0,    0,    0,    0,    0,    0,    0,    0,    0,    0],
    [   0,    0,    0,    0,    0,    0,    0,    0,    0,    0,    0,    0,    0,    0,    0,    0,    0,    0,    0,    0,    0,    0,    0,    0,    0,    0,    0,    0,    0,    0,    0,    0,    0,    0,    0,    0,    0,    0,    0,    0,    0,    0,    0,    0,    0,    0,    0,    0,    0,    0],
    [   0,    0,    0,    0,    0,    0,    0,    0,    0,    0,    0,    0,    0,    0,    0,    0,    0,    0,    0,    0,    0,    0,    0,    0,    0,    0,    0,    0,    0,    0,    0,    0,    0,    0,    0,    0,    0,    0,    0,    0,    0,    0,    0,    0,    0,    0,    0,    0,    0,    0],
    [   0,    0,    0,    0,    0,    0,    0,    0,    0,    0,    0,    0,    0,    0,    0,    0,    0,    0,    0,    0,    0,    0,    0,    0,    0,    0,    0,    0,    0,    0,    0,    0,    0,    0,    0,    0,    0,    0,    0,    0,    0,    0,    0,    0,    0,    0,    0,    0,    0,    0],
    [   0,    0,    0,    0,    0,    0,    0,    0,    0,    0,    0,    0,    0,    0,    0,    0,    0,    0,    0,    0,    0,    0,    0,    0,    0,    0,    0,    0,    0,    0,    0,    0,    0,    0,    0,    0,    0,    0,    0,    0,    0,    0,    0,    0,    0,    0,    0,    0,    0,    0],
    [   0,    0,    0,    0,    0,    0,    0,    0,    0,    0,    0,    0,    0,    0,    0,    0,    0,    0,    0,    0,    0,    0,    0,    0,    0,    0,    0,    0,    0,    0,    0,    0,    0,    0,    0,    0,    0,    0,    0,    0,    0,    0,    0,    0,    0,    0,    0,    0,    0,    0],
    [   0,    0,    0,    0,    0,    0,    0,    0,    0,    0,    0,    0,    0,    0,    0,    0,    0,    0,    0,    0,    0,    0,    0,    0,    0,    0,    0,    0,    0,    0,    0,    0,    0,    0,    0,    0,    0,    0,    0,    0,    0,    0,    0,    0,    0,    0,    0,    0,    0,    0],
    [   0,    0,    0,    0,    0,    0,    0,    0,    0,    0,    0,    0,    0,    0,    0,    0,    0,    0,    0,    0,    0,    0,    0,    0,    0,    0,    0,    0,    0,    0,    0,    0,    0,    0,    0,    0,    0,    0,    0,    0,    0,    0,    0,    0,    0,    0,    0,    0,    0,    0],
    [   0,    0,    0,    0,    0,    0,    0,    0,    0,    0,    0,    0,    0,    0,    0,    0,    0,    0,    0,    0,    0,    0,    0,    0,    0,    0,    0,    0,    0,    0,    0,    0,    0,    0,    0,    0,    0,    0,    0,    0,    0,    0,    0,    0,    0,    0,    0,    0,    0,    0],
    [   0,    0,    0,    0,    0,    0,    0,    0,    0,    0,    0,    0,    0,    0,    0,    0,    0,    0,    0,    0,    0,    0,    0,    0,    0,    0,    0,    0,    0,    0,    0,    0,    0,    0,    0,    0,    0,    0,    0,    0,    0,    0,    0,    0,    0,    0,    0,    0,    0,    0],
    [   0,    0,    0,    0,    0,    0,    0,    0,    0,    0,    0,    0,    0,    0,    0,    0,    0,    0,    0,    0,    0,    0,    0,    0,    0,    0,    0,    0,    0,    0,    0,    0,    0,    0,    0,    0,    0,    0,    0,    0,    0,    0,    0,    0,    0,    0,    0,    0,    0,    0],
    [   0,    0,    0,    0,    0,    0,    0,    0,    0,    0,    0,    0,    0,    0,    0,    0,    0,    0,    0,    0,    0,    0,    0,    0,    0,    0,    0,    0,    0,    0,    0,    0,    0,    0,    0,    0,    0,    0,    0,    0,    0,    0,    0,    0,    0,    0,    0,    0,    0,    0],
    [   0,    0,    0,    0,    0,    0,    0,    0,    0,    0,    0,    0,    0,    0,    0,    0,    0,    0,    0,    0,    0,    0,    0,    0,    0,    0,    0,    0,    0,    0,    0,    0,    0,    0,    0,    0,    0,    0,    0,    0,    0,    0,    0,    0,    0,    0,    0,    0,    0,    0],
    [   0,    0,    0,    0,    0,    0,    0,    0,    0,    0,    0,    0,    0,    0,    0,    0,    0,    0,    0,    0,    0,    0,    0,    0,    0,    0,    0,    0,    0,    0,    0,    0,    0,    0,    0,    0,    0,    0,    0,    0,    0,    0,    0,    0,    0,    0,    0,    0,    0,    0],
    [   0,    0,    0,    0,    0,    0,    0,    0,    0,    0,    0,    0,    0,    0,    0,    0,    0,    0,    0,    0,    0,    0,    0,    0,    0,    0,    0,    0,    0,    0,    0,    0,    0,    0,    0,    0,    0,    0,    0,    0,    0,    0,    0,    0,    0,    0,    0,    0,    0,    0],
    [   0,    0,    0,    0,    0,    0,    0,    0,    0,    0,    0,    0,    0,    0,    0,    0,    0,    0,    0,    0,    0,    0,    0,    0,    0,    0,    0,    0,    0,    0,    0,    0,    0,    0,    0,    0,    0,    0,    0,    0,    0,    0,    0,    0,    0,    0,    0,    0,    0,    0],
    [   0,    0,    0,    0,    0,    0,    0,    0,    0,    0,    0,    0,    0,    0,    0,    0,    0,    0,    0,    0,    0,    0,    0,    0,    0,    0,    0,    0,    0,    0,    0,    0,    0,    0,    0,    0,    0,    0,    0,    0,    0,    0,    0,    0,    0,    0,    0,    0,    0,    0],
    [   0,    0,    0,    0,    0,    0,    0,    0,    0,    0,    0,    0,    0,    0,    0,    0,    0,    0,    0,    0,    0,    0,    0,    0,    0,    0,    0,    0,    0,    0,    0,    0,    0,    0,    0,    0,    0,    0,    0,    0,    0,    0,    0,    0,    0,    0,    0,    0,    0,    0],
    [   0,    0,    0,    0,    0,    0,    0,    0,    0,    0,    0,    0,    0,    0,    0,    0,    0,    0,    0,    0,    0,    0,    0,    0,    0,    0,    0,    0,    0,    0,    0,    0,    0,    0,    0,    0,    0,    0,    0,    0,    0,    0,    0,    0,    0,    0,    0,    0,    0,    0],
    [   0,    0,    0,    0,    0,    0,    0,    0,    0,    0,    0,    0,    0,    0,    0,    0,    0,    0,    0,    0,    0,    0,    0,    0,    0,    0,    0,    0,    0,    0,    0,    0,    0,    0,    0,    0,    0,  175,  176,  177,  178,    0,    0,    0,    0,    0,    0,    0,    0,    0],
    [   0,    0,    0,    0,    0,    0,    0,    0,    0,    0,    0,    0,    0,    0,    0,    0,    0,    0,    0,    0,    0,    0,    0,    0,    0,    0,    0,    0,    0,    0,    0,    0,    0,    0,    0,    0,    0,  205,  206,  207,  208,    0,    0,    0,    0,    0,    0,    0,    0,    0],
    [   0,    0,    0,    0,    0,    0,    0,    0,    0,    0,    0,    0,    0,    0,    0,    0,    0,    0,    0,    0,    0,    0,    0,    0,    0,    0,    0,    0,    0,    0,    0,    0,    0,    0,    0,    0,    0,  235,  236,  237,  238,    0,    0,    0,    0,    0,    0,    0,    0,    0],
    [   0,    0,    0,    0,    0,    0,    0,    0,    0,    0,    0,    0,    0,    0,    0,    0,    0,    0,    0,    0,    0,    0,    0,    0,    0,    0,    0,    0,    0,    0,    0,    0,    0,    0,    0,    0,    0,  265,  266,  267,  268,    0,    0,    0,    0,  175,  176,  177,  178,    0],
    [   0,    0,    0,    0,    0,    0,    0,    0,    0,    0,    0,    0,    0,    0,    0,    0,    0,    0,    0,    0,    0,    0,    0,    0,    0,    0,    0,    0,    0,    0,    0,    0,    0,    0,    0,    0,    0,    0,    0,    0,    0,    0,    0,    0,    0,  205,  206,  207,  208,    0],
    [   0,    0,    0,    0,    0,    0,    0,    0,    0,    0,    0,    0,    0,    0,    0,    0,    0,    0,    0,    0,    0,    0,    0,    0,    0,    0,    0,    0,    0,    0,    0,    0,    0,    0,    0,    0,    0,    0,    0,    0,    0,    0,    0,    0,    0,  235,  236,  237,  238,    0],
    [   0,    0,    0,    0,    0,    0,    0,    0,    0,    0,    0,    0,    0,    0,    0,    0,    0,    0,    0,    0,    0,    0,    0,    0,    0,    0,    0,    0,    0,    0,    0,    0,    0,    0,    0,    0,    0,    0,    0,    0,    0,    0,    0,    0,    0,  265,  266,  267,  268,    0],
    [   0,    0,    0,    0,    0,    0,    0,    0,    0,    0,    0,    0,    0,    0,    0,    0,    0,    0,    0,    0,    0,    0,    0,    0,    0,    0,    0,    0,    0,    0,    0,    0,    0,    0,    0,    0,    0,    0,    0,    0,    0,    0,    0,    0,    0,    0,    0,    0,    0,    0]
  ]
}