{
  "largeur": 50,
  "hauteur": 30,
  "chipset": "VillageTangaFinal.png",
  "musique": "bahamut_lagoon.ogg",
  "couche0": [
    [ 433,  434,  435,  436,  433,  434,  435,  436,  433,  434,  435,  436,  433,  434,  435,  436,  433,  434,  435,  436,  433,  434,  435,  436,  433,  434,  435,  436,  433,  434,  435,  436,  433,  434,  435,  436,  433,  434,  435,  436,  433,  434,  435,  436,  433,  434,  435,  436,  433,  436],
    [ 500,  501,  502,  503,  500,  501,  502,  503,  500,  501,  502,  503,  500,  501,  502,  503,  500,  501,  502,  503,  500,  501,  502,  503,  500,  501,  502,  503,  500,  501,  502,  503,  500,  501,  502,  503,  500,  501,  502,  503,  500,  501,  502,  503,  500,  501,  502,  503,  500,  501],
    [ 567,  568,  569,  570,  567,  568,  569,  570,  567,  568,  569,  570,  567,  569,  569,  570,  567,  568,  569,  570,  567,  568,  569,  570,  567,  568,  569,  570,  567,  568,  569,  570,  567,  568,  569,  570,  567,  568,  569,  570,  567,  568,  569,  570,  567,  568,  569,  570,  567,  568],
    [ 634,  635,  636,  637,  634,  635,  636,  635,  634,  635,  636,  637,  634,  635,  636,  637,  634,  635,  636,  637,  634,  635,  636,  637,  634,  635,  636,  637,  634,  635,  636,  637,  634,  635,  636,  637,  634,  635,  636,  637,  634,  635,  636,  637,  634,  635,  636,  637,  634,  635],
    [ 809,  809,  809,  809,  809,  875,  876,  876,  876,  876,  876,  877,  809,  809,  809,  809,  809,  809,  809,  875,  876,  876,  876,  876,  876,  876,  877,  809,  809,  809,  809,  809,  809,  809,  809,  809,  809,  809,  809,  809,  809,  809,  809,  809,  809,  809,  809,  809,  809,  809],
    [ 809,  809,  809,  809,  809, 1009, 1010,  546,  943,  546, 1010, 1011,  809,  809,  809,  809,  809,  809,  875,  943,  943,  943,  943,  943,  943,  943,  944,  809,  809,  809,  809,  809,  809,  809,  809,  809,  342,  343,  343,  343,  344,  809,  809,  809,  809,  809,  809,  809,  809,  809],
    [ 809,  809,  809,  809,  809,  809,  809, 1009, 1010, 1011,  809,  809,    7,  809,  809,  809,  809,  809,  942,  943,  943,  943,  943,  943,  943,  943, 1011,  809,  809,  809,  809,  809,  809,  809,  809,  809,  409,  410,  410,  410,  411,  809,  809,  809,  809,  809,  809,  809,  809,  809],
    [ 809,  809,  809,  809,  809,  809,  809,  610,  611,  611,  611,  611,  612,  809,  809,  809,  809,  809, 1009, 1010, 1010, 1010,  943,  943,  943, 1011,  809,  809,  809,  809,  809,  809,  809,  809,  809,  809,  476,  477,  477,  477,  478,  809,  809,  809,  809,  809,  809,  809,  809,  809],
    [ 809,  809,  809,  809,  809,  809,  610,  678,  678,  678,  678,  678,  679,  809,  809,    7,  809,  809,  809,  809,  809,  809, 1009, 1010, 1011,  809,  809,  809,  809,  809,  809,  809,    7,  809,  809,  809,  809,  809,  809,  809,  809,  809,  809,  809,  809,  809,  809,  809,  809,  809],
    [ 809,  809,  809,  809,  809,  610,  678,  678,  678,  678,  678,  678,  746,  809,  809,  809,  809,  809,  809,  809,  809,  809,  809,  809,  809,  809,  809,  809,  809,  809,  809,  809,  809,  809,  809,  809,    7,  809,  809,  809,  809,  809,  809,  809,  809,  809,  809,  809,  809,  809],
    [ 809,  809,  809,  809,  809,  677,  678,  678,  678,  678,  678,  746,  809,  809,  809,  809,  809,  809,  809,  809,  809,  809,  809,  809,  809,  809,  809,  809,  809,  809,  809,  809,  809,  809,  809,  809,  809,  809,  809,  809,  809,  809,  809,  809,  809,  809,  809,  809,  809,  809],
    [ 809,  809,  809,  809,  809,  744,  745,  745,  745,  745,  746,  809,  809,  809,  809,  809,  809,  809,  809,  809,  809,  809,  809,  809,  809,  809,  809,  809,  809,  809,  809,  809,  809,  809,  809,  809,  809,  809,  809,  809,  809,  809,  809,  809,  809,  809,  809,  809,  809,  809],
    [ 873,  873,  873,  873,  873,  873,  873,  873,  873,  873,  873,  873,  873,  873,  873,  873,  873,  873,  873,  873,  873,  873,  873,  873,  873,  873,  873,  873,  873,  873,  873,  873,  873,  873,  873,  873,  873,  873,  873,  873,  873,  873,  873,  873,  873,  873,  873,  873,  873,  873],
    [ 940,  940,  940,  940,  940,  940,  940,  940,  940,  940,  940,  940,  940,  940,  940,  940,  940,  940,  940,  940,  940,  940,  940,  940,  940,  940,  940,  940,  940,  940,  940,  940,  940,  940,  940,  940,  940,  940,  940,  940,  940,  940,  940,  940,  940,  940,  940,  940,  940,  940],
    [1007, 1007, 1007, 1007, 1007, 1007, 1007, 1007, 1007, 1007, 1007, 1007, 1007, 1007, 1007, 1007, 1007, 1007, 1007, 1007, 1007, 1007, 1007, 1007,  940,  940,  940, 1007, 1007, 1007, 1007, 1007, 1007, 1007, 1007, 1007, 1007, 1007, 1007, 1007, 1007, 1007, 1007, 1007, 1007, 1007, 1007, 1007, 1007, 1007],
    [ 809,  809,  809,  809,  809,  809,  809,  809,  809,  809,  809,  809,  809,  809,   74,   75,   76,  809,  809,  809,  809,  809,  809,  809,  939,  940,  941,  809,  809,  809,  809,  809,  809,  809,  809,  809,  809,  809,  809,  809,  809,  809,  809,  809,  809,  809,  809,  809,  610,  611],
    [ 809,  809,  809,  809,  809,  809,  809,  809,  809,  809,  809,  809,  809,   74,  142,  142,  142,   75,   76,    7,  809,  809,  809,  809,  939,  940,  941,  809,  809,  809,  809,  809,  809,  809,  809,  809,  809,  809,  809,   74,   75,   76,  809,  809,  809,  809,  809,  610,  678,  678],
    [ 809,  809,  809,  809,  809,  809,  809,  809,  809,  809,  809,  809,   74,  142,  142,  142,  142,  142,  143,  809,  809,  809,  809,  809,  939,  940,  941,  809,    7,  809,  809,  809,  809,  809,  809,  809,  809,  809,    8,   74,  142,  142,   75,   76,  809,  809,  610,  678,  678,  678],
    [ 809,  809,  809,  809,  809,  809,  809,  809,  809,    7,  809,  809,  208,  142,  142,  142,  142,  142,  143,  809,  809,  809,  809,  809,  939,  940,  941,  809,  809,  809,  809,  809,  809,  610,  611,  612,  809,  809,  809,  141,  142,  142,  142,  143,  809,  809,  745,  678,  678,  678],
    [ 809,  809,  809,  809,  809,  809,  809,  809,  809,  809,  809,  809,  208,  208,  209,  209,  209,  209,  209,  809,  809,  809,  809,  809,  939,  940,  941,  809,  809,  809,  809,  809,    7,  677,  678,  678,  612,  809,  809,  141,  142,  142,  142,  210,  809,  809,  809,  745,  745,  745],
    [ 809,  809,  809,  809,  809,  809,  809,  809,  809,  809,  809,  610,  612,  809,  809,  809,  809,  809,  809,  809,  809,  809,  809,  809,  939,  940,  941,  809,  809,  809,  809,  809,  809,  744,  678,  678,  678,  612,  809,  208,  142,  142,  143,  809,  809,  809,  809,  809,  809,  809],
    [ 809,  809,  809,  809,  809,  809,  809,  809,  809,  809,  610,  678,  678,  612,  809,  342,  343,  343,  343,  343,  344,  809,  809,  809,  939,  940,  941,  809,  809,  809,  809,  809,  809,  809,  744,  678,  678,  679,  809,  809,  208,  209,  210,  809,  809,  809,  809,  809,  610,  611],
    [ 809,  809,  809,  809,  809,  809,  809,  809,  809,  610,  678,  678,  678,  746,  809,  409,  410,  410,  410,  410,  411,  809,  809,  809,  939,  940,  941,  809,  809,  809,  809,  809,  809,  809,  809,  744,  745,  746,  809,  809,  809,  809,  809,  809,  809,  809,  809,  610,  678,  678],
    [ 809,  809,  809,  809,  809,  809,  809,  809,  809,  677,  678,  678,  746,    7,  809,  409,  410,  410,  410,  410,  411,  809,    7,  809,  939,  940,  941,  809,  809,  809,  809,  809,  809,  809,  809,  809,  809,  809,  809,  809,  809,  809,  809,  809,  809,  809,  809,  610,  678,  678],
    [ 809,  809,  809,  809,  809,  809,  809,  809,  809,  744,  745,  746,  809,  809,  809,  409,  410,  410,  410,  410,  411,  809,  809,  809,  939,  940,  941,  809,  809,  809,  809,  809,  809,  809,  342,  343,  344,  809,  809,  809,  809,  809,  809,  809,  809,  809,  809,  677,  678,  678],
    [ 809,  809,  809,  809,  809,  809,  809,  809,  809,  809,  809,  809,  809,  809,  809,  476,  477,  477,  477,  477,  478,  809,  809,  809,  939,  940,  941,  809,  809,  809,  809,  809,  809,  809,  409,  410,  411,  809,  809,  809,  809,  809,  809,  809,  809,  809,  610,  678,  678,  678],
    [ 809,  809,  809,  809,  809,  809,  809,  809,  809,  809,  809,  809,  809,  809,  809,  809,    7,  809,  809,  809,    7,  809,  809,  809,  939,  940,  941,  809,  809,  809,  809,  809,  809,  809,  476,  477,  478,  809,  809,  809,  809,  809,  809,  809,  809,  809,  677,  678,  678,  678],
    [ 809,  809,  809,  809,  809,  809,  809,  809,  809,  809,  809,  809,  610,  611,  612,  809,  809,  809,  809,  809,  809,  809,  809,  809,  939,  940,  941,  809,  809,  809,  809,  809,  809,  809,  809,  809,  809,  809,  809,  809,  809,  809,  809,  809,  809,  610,  678,  678,  678,  678],
    [ 809,  809,  809,  809,  809,  809,  809,  809,  809,  809,  809,  610,  678,  678,  678,  611,  612,  809,  809,  809,  809,  809,  809,  809,  939,  940,  941,  809,  809,  809,  809,  809,  809,    9,  809,  809,  809,  809,  809,  809,  809,  809,  809,  809,  610,  678,  678,  678,  678,  678],
    [ 809,  809,  809,  809,  809,  809,  809,  809,  809,  809,  610,  678,  678,  678,  678,  678,  678,  611,  612,  809,  809,  809,  809,  809, 1006, 1007, 1008,  809,  809,  809,  809,  809,  809,  809,  809,  809,  809,  809,  809,  809,  809,  809,  809,  610,  678,  678,  678,  678,  678,  678]
  ],
  "couche1": [
    [   0,    0,    0,    0,    0,    0,    0,    0,    0,    0,    0,    0,    0,    0,    0,    0,    0,    0,    0,    0,    0,    0,    0,    0,    0,    0,    0,    0,    0,    0,    0,    0,    0,    0,    0,    0,    0,    0,    0,    0,    0,    0,    0,    0,    0,    0,    0,    0,    0,    0],
    [   0,    0,    0,    0,    0,    0,    0,    0,    0,    0,    0,    0,    0,    0,    0,    0,    0,    0,    0,    0,    0,    0,    0,    0,    0,    0,    0,    0,    0,    0,    0,    0,    0,    0,    0,    0,    0,    0,    0,    0,    0,    0,    0,    0,    0,    0,    0,    0,    0,    0],
    [   0,    0,    0,    0,    0,    0,    0,    0,    0,    0,    0,    0,    0,    0,    0,    0,    0,    0,    0,    0,    0,    0,    0,    0,    0,    0,    0,    0,    0,    0,    0,    0,    0,    0,    0,    0,    0,    0,    0,    0,    0,    0,    0,    0,    0,    0,    0,    0,    0,    0],
    [   0,    0,    0,    0,    0,    0,    0,    0,    0,    0,    0,    0,    0,    0,    0,    0,    0,    0,    0,    0,    0,    0,    0,    0,    0,    0,    0,    0,    0,    0,    0,    0,    0,    0,    0,    0,    0,    0,    0,    0,    0,    0,    0,    0,    0,    0,    0,    0,    0,    0],
    [   0,    0,    0,    0,    0,  369,  370,  371,    0,    0,    0,    0,    0,    0,    0,    0,    0,    0,    0,    0,    0,    0,    0,    0,    0,    0,    0,    0,    0,    0,    0,    0,    0,    0,    0,    0,    0,    0,  369,  370,  371,    0,    0,    0,    0,    0,    0,    0, 1054, 1055],
    [ 313,  314,  315,    0,    0,    0,    0,    0,  369,  370,  371,  756,    0,  305,  306,  307,  308,    0,    0,  369,  370,  371,  369,  370,  371,    0,    0,    0,    0,    0,    0,  369,  370,  371,    0,    0,    0,    0,  840,    0,    0,    0,    0,    0,    0,    0,    0,    0,    0,    0],
    [   0,    0,    0,    0,    0,    0,    0,  369,  370,  371,    0,    0,    0,    0,    0,    0,    0,    0,    0,    0,  369,  370,  371,    0,    0,    0,    0,    0,    0,    0,    0,    0,  906,    0,    0,    0,    0,  689,    0,    0,    0,    0,    0,    0,  103,    0,    0,    0,    0,    0],
    [   0,    0,    0,   36,    0,    0,    0,  839,    0,    0,    0,    0,    0,    0,    0,    0,    0,    0,  369,  370,  371,  369,  370,  371,    0,    0,    0,  840,    0,    0,    0,    0,    0,  839,    0,    0,   50,    0,    0,    0,    0,    0,    0,    0,    0,    0,    0,    0,    0,    0],
    [   0,    0,    0, 1054, 1055,    0,    0,    0,    0,    0,    0,    0,    0,  840,    0,    0,    0,    0,    0,    0,    0,    0,  369,  370,  371,    0,    0,    0,   36,    0,    0,    0,    0,    0,    0,    0,    0,    0,    0,    0,    0,  839,    0,    0,    0,    0,  840,    0,    0,    0],
    [   0,    0,    0,    0,    0,  117,    0,    0,    0,    0,  840,    0,    0,    0,    0,    0,    0,    0,    0,  504,  505,    0,    0,    0,    0,    0,    0,    0,    0,    0,    0,    0,    0,    0,    0,    0,    0,    0,    0,  254,    0,    0,    0,    0,    0,    0,    0,    0,    0,    0],
    [   0,  823,  824,    0,    0,    0,  456,    0,    0,    0,    0,    0, 1054, 1055,    0,    0,    0,    0,    0,    0,    0,    0,    0,    6,    0,    0,    0,    0,    0,    0,    0,  584,  585,    0,    0,    0,    0,    0,    0,    0,    0,    0,    0,    0,    0,    0,    0,    0,  456,    0],
    [   0,    0,    0,    0,    0,    0,    0, 1051, 1052,  182,    0,    0,    0,    0,    0,    0,    0,    0,    0,    0,    0,    0,    0,    0,    0,    0,    0,    0,    0,    0,    0,    0,    0,    0,    0,    0,    0,    0,    0,    0,    0,    0,    0,    0,    0,    0,    0,    0,    0,    0],
    [   0,    0,    0,    0,    0,    0,    0,    0,    0,    0,    0,    0,    0,    0,    0,    0,    0,    0,    0,    0,    0,    0,    0,    0,    0,    0,    0,    0,    0,    0,    0,    0,    0,    0,    0,    0,    0,    0,    0,    0,    0,    0,    0,    0,    0,    0,    0,    0,    0,    0],
    [   0,    0,    0,    0,    0,    0,    0,    0,    0,    0,    0,    0,    0,    0,    0,    0,    0,    0,    0,    0,    0,    0,    0,    0,    0,    0,    0,    0,    0,    0,    0,    0,    0,    0,    0,    0,    0,    0,    0,    0,    0,    0,    0,    0,    0,    0,    0,    0,    0,    0],
    [   0,    0,    0,    0,    0,    0,    0,    0,    0,    0,    0,    0,    0,    0,    0,    0,    0,    0,    0,    0,    0,    0,    0,    0,    0,    0,    0,    0,    0,    0,    0,    0,    0,    0,    0,    0,    0,    0,    0,    0,    0,    0,    0,    0,    0,    0,    0,    0,    0,    0],
    [   0,    0,    0,    0,    0,    0,    0,    0,    0,    0,    0,    0,    0,    0,    0,    0,    0,    0,    0,    0,    0,    0,    0,    0,    0,    0,    0,    0,    0,    0,    0,    0,    0,    0,    0,    0,    0,    0,    0,    0,  305,  306,  307,  308,    0,    0,    0,    0,    0,    0],
    [   0,    0,    0,    0,    0,    0,    0,    0,    0,    0,  756,    0,    0,    0,  254,    0,    0,    0,    0,    0,    0,    0,    0,    0,    0,    0,    0,  584,  585,    0,    0,    0,    0,    0,  456,    0,    0,    0,    0,    0,    0,    0,    0,    0,    0,    0,    0,    0,    0,    0],
    [   0,    0,    0,    0,    0,  840,    0,    0,    0,    0,    0,    0,    0,    0,    0,    0,    0,    0,    0,    0,  305,  306,  307,  308,    0,    0,    0,    0,    0,    0,    0,    0,    0,    0,    0,    0,    0,    0,    0,    0,    0,    0,    0,    0,    0,    0,    0,    0,    0,    0],
    [   0,    0,    0,    0,    0,    0,    0,  305,  306,  307,  308,    0,    0,    0,    0,    0,    0,    0,    0,    0,    0,    0,    0,    0,    0,    0,    0,    0,    0,    0,    0,    0,    0,    0,    0,    0,  103,    0,    0,    0,    0,    0,    0,  504,  505,    0,    0,    0,    0,    0],
    [   0,    0,    0,  756,    0,    0,    0,  388,    0,    0,    0,    0,    0,  182,    0,    0,    0,    0,    0,    0,    0,    0,    0,    0,    0,    0,    0,    0,    0,    0,    0,    0,    0,    0,    0,    0,    0,    0,    0,    0,    0,    0,    0,    0,    0,    0,    0,    0,    0,    0],
    [   0, 1051, 1052,    0,    0,    0,    0,    0,    0,    0,    0,    0,    0,    0,    0,    0,    0,    0,    0,    0,    0,    0,    0,    0,    0,    0,    0,    0,    0,    0,    0,  840,    0,    0,    0,    0,    0,    0,    0,  309,  310,  311,  312,    0,    0,    0,    0,    0,    0,    0],
    [   0,    0,    0,    0,    0,    0,    0,    0,    0,    0,    0,    0,    0,    0,    0,    0,    0,    0,    0,    0,    0,    0, 1051, 1052,    0,    0,    0,    0,    0,    0,    0,    0,    0,    0,    0,    0,    0,    0,  839,    0,    0,    0,    0,    0,  839,    0,    0,    0,    0,    0],
    [   0,    0,    0,    0,    0,    0,    0,    0,    0,  839,    0,    0,    0,    0,    0,    0,  689,    0,    0,    0,    0,    0,    0,    0,    0,    0,    0,    0,    0,    0,  756,    0,    0,    0,    0,    0,    0,    0,    0,    0,    0,    0,    0,    0,    0,    0,    0,    0,    0,    0],
    [   0,    0,    0,  504,  505,    0,    0,    0,    0,    0,    0,    0, 1051, 1052,    0,    0,    0,    0,  894,    0,    0,    0,    0,    0,    0,    0,    0,    0,    0,    0,    0,    0,    0,    0,    0,    0,    0,    0,   49,    0,    0,    0,    0,    0,    0,    0,    0,    0,    0,    0],
    [   0,    0,    0,    0,    0,    0,    0,  906,    0,    0,    0,    0,    0,    0,    0,    0,  906,    0,    0,    0,  906,    0,    0,    0,    0,    0,    0,    0,    0,    0,    0,    0,    0,    0,    0,    0,    0,    0,    0,    0,    0,    0,  840,    0,    0,    0,  784,  785,    0,    0],
    [   0,  584,  585,    0,    0,    0,    0,    0,    0,    0,    0,    0,    0,    0,    0,    0,    0,    0,    0,    0,  839,    0,    0,    0,    0,    0,    0,    0,    0,    0,  840,    0,    0,    0,    0,  894,    0,    0,    0,    0,    0,    0,    0,    0,    0,    0,    0,    0,    0,    0],
    [   0,    0,    0,    0,    0,    0,    0,    0,    0,    0,    0,    0,    0,  840,    0,    0,    0,  314,    0,    0,    0,    0,    0,    0,    0,    0,    0,    0,    0,    0,    0,    0,    0,    0,    0,    0,    0,  103,    0,    0,    0,    0,    0,    0,    0,    0,    0,    0,    0,    0],
    [   0,    0,    0,  555,    0,    0,  456,    0,    0,    0,    0,    0,    0,    0,    0,    0,    0,    0,    0,    0,    0,    0,    0,    0,    0,    0,    0,    0,    0,    0,  254,    0,    0,    0,    0,    0,    0,    0,    0,    0,    0,  305,  306,  307,  308,    0,    0,    0,    0,    0],
    [   0,    0,    0,    0,    0,    0,    0,    0,    0,    0,    0,    0,    0,    0,    0,    0,    0,    0,    0,    0,    0, 1051, 1052,    0,    0,    0,    0,    0,    0,    0,    0,    0,    0,    0,  456,    0,    0,    0, 1051, 1052,    0,    0,    0,    0,    0,    0,    0,    0,    0,    0],
    [   0,    0,    0,    0,    0,    0,    0,  784,  785,    0,    0,    0,    0,    0,    0,    0,    0,    0,    0,    0,    0,    0,    0,    0,    0,    0,    0,    0,    0,    0,    0,    0,    0,    0,    0,    0,    0,    0,    0,    0,    0,    0,    0,    0,    0,    0,    0,    0,    0,    0]
  ],
  "couche2": [
    [   0,    0,    0,    0,    0,    0,    0,    0,    0,    0,    0,    0,    0,    0,    0,    0,    0,    0,    0,    0,    0,    0,    0,    0,    0,    0,    0,    0,    0,    0,    0,    0,    0,    0,    0,    0,    0,    0,    0,    0,    0,    0,    0,    0,    0,    0,    0,    0,    0,    0],
    [   0,    0,    0,    0,    0,    0,    0,    0,    0,    0,    0,    0,    0,   37,   38,   39,   40,    0,    0,    0,    0,    0,    0,    0,    0,    0,    0,    0,    0,    0,    0,    0,    0,    0,    0,    0,    0,    0,    0,    0,    0,    0,    0,    0,    0,    0,    0,    0,    0,    0],
    [   0,    0,    0,    0,    0,    0,    0,    0,    0,    0,    0,    0,    0,  104,  105,  106,  107,    0,    0,    0,    0,    0,    0,    0,    0,    0,    0,    0,    0,    0,    0,    0,    0,    0,    0,    0,    0,    0,    0,    0,    0,    0,    0,    0,    0,    0,    0,    0,    0,    0],
    [   0,    0,    0,    0,    0,    0,    0,    0,    0,    0,    0,    0,    0,  171,  172,  173,  174,    0,    0,    0,    0,    0,    0,    0,    0,    0,    0,    0,    0,    0,    0,    0,    0,    0,    0,    0,    0,    0,    0,    0,    0,    0,    0,    0,    0,    0,    0,    0,    0,    0],
    [   0,    0,    0,    0,    0,    0,    0,    0,    0,    0,    0,    0,    0,  238,  239,  240,  241,    0,    0,    0,    0,    0,    0,    0,    0,    0,    0,    0,    0,    0,    0,    0,    0,    0,    0,    0,    0,    0,    0,    0,    0,    0,    0,    0,    0,    0,    0,    0,    0,    0],
    [   0,    0,    0,    0,    0,    0,    0,    0,    0,    0,    0,    0,    0,    0,    0,    0,    0,    0,    0,    0,    0,    0,    0,    0,    0,    0,    0,    0,    0,    0,    0,    0,    0,    0,    0,    0,    0,    0,    0,    0,    0,    0,    0,    0,    0,    0,    0,    0,    0,    0],
    [   0,    0,    0,    0,    0,    0,    0,    0,    0,    0,    0,    0,    0,    0,    0,    0,    0,    0,    0,    0,    0,    0,    0,    0,    0,    0,    0,    0,    0,    0,  315,  316,  317,  318,    0,    0,    0,    0,    0,    0,    0,    0,    0,    0,    0,    0,    0,    0,    0,    0],
    [   0,    0,    0,    0,    0,    0,    0,    0,    0,    0,    0,    0,    0,    0,    0,    0,    0,    0,    0,    0,    0,    0,    0,    0,    0,    0,    0,    0,    0,    0,  382,  383,  384,  385,    0,    0,    0,    0,    0,    0,    0,    0,    0,    0,    0,    0,    0,    0,    0,    0],
    [   0,    0,    0,    0,    0,    0,  849,  850,  851,  852,    0,    0,    0,    0,    0,    0,    0,    0,    0,  437,  438,    0,    0,    0,    0,    0,    0,    0,    0,    0,  449,  450,  451,  452,    0,    0,    0,    0,    0,    0,    0,    0,    0,    0,    0,    0,    0,    0,    0,    0],
    [   0,    0,    0,    0,    0,    0,  916,  917,  918,  919,    0,    0,    0,    0,    0,    0,    0,    0,    0,    0,    0,    0,    0,    0,    0,    0,    0,    0,    0,    0,  516,  517,  518,  519,    0,    0,    0,    0,    0,    0,    0,    0,    0,    0,    0,    0,    0,    0,    0,    0],
    [   0,    0,    0,    0,    0,    0,  983,  984,  985,  986,    0,    0,    0,    0,    0,    0,    0,    0,    0,    0,    0,    0,    0,    0,    0,    0,    0,    0,    0,    0,    0,    0,    0,    0,    0,    0,    0,    0,    0,    0,    0,    0,    0,    0,    0,    0,    0,    0,    0,    0],
    [   0,    0,    0,    0,    0,    0,    0,    0,    0,    0,    0,    0,    0,    0,    0,    0,    0,    0,    0,    0,    0,    0,    0,    0,    0,    0,    0,    0,    0,    0,    0,    0,    0,    0,    0,    0,    0,    0,    0,    0,   37,   38,   39,   40,    0,    0,    0,    0,    0,    0],
    [   0,    0,    0,    0,    0,    0,    0,    0,    0,    0,    0,    0,    0,    0,    0,    0,    0,    0,    0,    0,    0,    0,    0,    0,    0,    0,  315,  316,  317,  318,    0,    0,    0,    0,    0,    0,    0,    0,    0,    0,  104,  105,  106,  107,    0,    0,    0,    0,    0,    0],
    [   0,    0,    0,    0,    0,    0,    0,    0,    0,    0,    0,    0,    0,    0,    0,    0,    0,    0,    0,    0,   37,   38,   39,   40,    0,    0,  382,  383,  384,  385,    0,    0,    0,    0,    0,    0,    0,    0,    0,    0,  171,  172,  173,  174,    0,    0,    0,    0,    0,    0],
    [   0,    0,    0,    0,    0,    0,    0,   37,   38,   39,   40,    0,    0,    0,    0,    0,    0,    0,    0,    0,  104,  105,  106,  107,    0,    0,  449,  450,  451,  452,    0,    0,    0,    0,    0,    0,    0,    0,    0,    0,  238,  239,  240,  241,    0,    0,    0,    0,    0,    0],
    [   0,    0,    0,    0,    0,    0,    0,  104,  105,  106,  107,    0,    0,    0,    0,    0,    0,    0,    0,    0,  171,  172,  173,  174,    0,    0,  516,  517,  518,  519,    0,    0,    0,    0,    0,    0,    0,    0,    0,    0,    0,    0,    0,    0,    0,    0,    0,    0,    0,    0],
    [   0,    0,    0,    0,    0,    0,    0,  171,  172,  173,  174,    0,    0,    0,    0,    0,    0,    0,    0,    0,  238,  239,  240,  241,    0,    0,    0,    0,    0,    0,    0,    0,    0,    0,    0,    0,    0,    0,    0,   41,   42,   43,   44,    0,    0,    0,    0,    0,    0,    0],
    [ 849,  850,  851,  852,    0,    0,    0,  238,  239,  240,  241,    0,    0,    0,    0,    0,    0,    0,    0,    0,    0,    0,    0,    0,    0,    0,    0,    0,    0,    0,    0,    0,    0,    0,    0,    0,    0,    0,    0,  108,  109,  110,  111,  437,  438,    0,    0,    0,    0,    0],
    [ 916,  917,  918,  919,    0,    0,    0,    0,    0,    0,    0,    0,    0,    0,    0,    0,    0,    0,    0,    0,    0,  849,  850,  851,  852,    0,    0,    0,    0,    0,    0,    0,    0,    0,    0,    0,    0,    0,    0,  175,  176,  177,  178,    0,    0,    0,    0,    0,    0,    0],
    [ 983,  984,  985,  986,    0,    0,    0,    0,    0,    0,    0,    0,    0,    0,    0,    0,    0,    0,    0,    0,    0,  916,  917,  918,  919,    0,    0,    0,    0,    0,    0,    0,    0,    0,    0,    0,    0,    0,    0,  242,  243,  244,  245,    0,    0,    0,    0,    0,    0,    0],
    [   0,    0,    0,    0,    0,    0,    0,    0,    0,    0,    0,  849,  850,  851,  852,    0,    0,    0,    0,    0,    0,  983,  984,  985,  986,    0,    0,    0,    0,    0,    0,    0,    0,    0,    0,    0,    0,    0,    0,    0,    0,    0,    0,    0,    0,    0,    0,    0,    0,    0],
    [ 315,  316,  317,  318,    0,    0,    0,    0,    0,    0,    0,  916,  917,  918,  919,    0,    0,    0,    0,    0,    0,    0,    0,    0,    0,    0,    0,    0,    0,    0,    0,    0,    0,    0,    0,    0,    0,    0,    0,    0,    0,    0,    0,    0,    0,    0,    0,    0,    0,    0],
    [ 382,  383,  384,  385,    0,    0,    0,    0,    0,    0,    0,  983,  984,  985,  986,    0,   45,   46,   47,    0,    0,    0,    0,    0,    0,    0,    0,    0,    0,    0,    0,    0,    0,    0,    0,    0,    0,    0,    0,    0,    0,    0,    0,    0,    0,    0,  650,  651,    0,    0],
    [ 449,  450,  451,  452,    0,    0,    0,    0,    0,    0,    0,    0,    0,    0,    0,    0,  112,  113,  114,    0,    0,    0,    0,    0,    0,    0,    0,    0,    0,    0,    0,    0,    0,    0,    0,    0,    0,    0,    0,    0,    0,   37,   38,   39,   40,    0,  717,  718,    0,    0],
    [ 516,  517,  518,  519,    0,    0,    0,    0,    0,    0,    0,    0,    0,    0,    0,    0,  179,  180,  181,    0,    0,    0,    0,    0,    0,    0,    0,    0,    0,    0,    0,    0,    0,    0,    0,    0,    0,    0,    0,    0,    0,  104,  105,  106,  107,    0,    0,    0,    0,    0],
    [   0,    0,    0,    0,    0,    0,    0,    0,    0,    0,    0,    0,    0,    0,    0,    0,  246,  247,  248,    0,  849,  850,  851,  852,    0,    0,    0,    0,    0,    0,    0,    0,    0,    0,    0,    0,    0,    0,  853,  854,    0,  171,  172,  173,  174,    0,    0,    0,    0,    0],
    [   0,    0,    0,    0,    0,    0,    0,    0,    0,    0,    0,    0,    0,    0,    0,    0,    0,    0,    0,    0,  916,  917,  918,  919,    0,    0,    0,    0,    0,    0,    0,    0,    0,    0,    0,    0,    0,    0,  920,  921,    0,  238,  239,  240,  241,    0,    0,    0,    0,    0],
    [   0,    0,    0,    0,    0,    0,    0,  650,  651,    0,    0,    0,    0,    0,    0,    0,    0,    0,    0,    0,  983,  984,  985,  986,    0,    0,    0,    0,    0,    0,    0,    0,    0,    0,    0,    0,    0,    0,  987,  988,    0,    0,    0,    0,    0,    0,    0,    0,    0,    0],
    [   0,    0,    0,    0,    0,    0,    0,  717,  718,    0,    0,    0,    0,    0,    0,    0,    0,    0,    0,    0,    0,    0,    0,    0,    0,    0,    0,    0,    0,    0,    0,    0,    0,    0,    0,    0,    0,    0,    0,    0,    0,    0,    0,    0,    0,    0,    0,    0,    0,    0],
    [   0,    0,    0,    0,    0,    0,    0,    0,    0,    0,    0,    0,    0,    0,    0,    0,    0,    0,    0,    0,    0,    0,    0,    0,    0,    0,    0,    0,    0,    0,    0,    0,    0,    0,    0,    0,    0,    0,    0,    0,    0,    0,    0,    0,    0,    0,    0,    0,    0,    0]
  ]
}