{
  "largeur": 20,
  "hauteur": 10,
  "chipset": "BZ.png",
  "musique": "Castle_1.ogg",
  "couche0": [
    [  12,   12,   12,   12,   12,   12,   12,   12,   12,   12,   12,   12,   12,   12,   12,   12,   12,   12,   12,   12],
    [  42,   42,   42,   42,   42,   42,   42,   42,   42,   42,   42,   42,   42,   42,   42,   42,   42,   42,   42,   42],
    [  72,   72,   72,   72,   72,   72,   72,   72,   72,   72,   72,   72,   72,   72,   72,   72,   72,   72,   72,   72],
    [ 424,  365,  365,  395,   60,  395,  395,  274,  275,  276,  395,  395,  395,  395,  395,  274,  275,  276,  395,  395],
    [ 388,  389,  390,  365,   60,  365,  365,  304,  305,  306,  365,  365,  365,  365,  365,  304,  305,  306,  365,  365],
    [ 424,  365,  365,  365,   60,  274,  275,  277,  305,  278,  275,  275,  275,  275,  275,  305,  305,  305,  276,  365],
    [ 424,  365,  365,  365,   60,  304,  305,  305,  305,  305,  305,  305,  305,  305,  305,  305,  305,  305,  306,  365],
    [ 424,  365,  365,  365,   60,  334,  335,  335,  335,  335,  335,  335,  335,  335,  335,  335,  335,  335,  336,  365],
    [ 388,  389,  390,  365,   90,  365,  365,  365,  365,  365,  365,  365,  365,  365,  365,  365,  365,  365,  365,  365],
    [ 424,  365,  365,  365,  365,  365,  365,  365,  365,   28,   27,   28,  365,  365,  365,  365,  365,  365,  365,  365]
  ],
  "couche1": [
    [   0,    0,    0,    0,    0,    0,    0,    0,    0,    0,    0,    0,    0,    0,    0,    0,    0,    0,    0,    0],
    [   0,    0,    0,  176,  177,    0,    0,    0,  297,    0,    0,   21,   22,    0,    0,    0,    0,    0,    0,    0],
    [   0,    0,    0,    0,   30,    0,    0,    0,  327,    0,    0,   51,   52,    0,    0,    0,    0,    0,    0,    0],
    [   0,    0,    0,    0,    0,    0,    0,    0,    0,    0,    0,   81,   82,    0,  266,    0,    0,    0,    0,    0],
    [   0,    0,    0,    0,    0,    0,  219,    0,    0,    0,    0,    0,    0,    0,    0,    0,    0,    0,    0,  219],
    [   0,    0,    0,    0,  300,    0,    0,    0,    0,    0,    0,    0,    0,    0,    0,    0,    0,    0,    0,    0],
    [   0,    0,    0,    0,    0,    0,    0,    0,    0,    0,    0,  298,  145,  270,    0,    0,    0,    0,    0,    0],
    [   0,    0,    0,    0,    0,    0,    0,    0,    0,    0,    0,    0,    0,    0,    0,    0,    0,    0,    0,    0],
    [   0,    0,    0,    0,    0,    0,    0,    0,    0,    0,    0,    0,    0,    0,    0,    0,    0,    0,    0,    0],
    [   0,    0,    0,    0,    0,    0,  219,    0,  415,    0,    0,    0,    0,    0,    0,    0,   83,   84,   85,  219]
  ],
  "couche2": [
    [   0,    0,    0,    0,    0,    0,    0,    0,    0,    0,    0,    0,    0,    0,    0,    0,    0,    0,    0,    0],
    [   0,    0,    0,    0,    0,    0,  129,    0,    0,    0,    0,   21,   22,    0,    0,    0,    0,    0,    0,  129],
    [ 328,  329,  330,    0,    0,    0,  159,    0,    0,    0,    0,   51,   52,    0,    0,    0,    0,    0,    0,  159],
    [ 358,  359,  360,    0,    0,    0,  189,    0,    0,    0,    0,    0,    0,    0,    0,    0,    0,    0,    0,  189],
    [   0,    0,    0,    0,    0,    0,    0,    0,    0,    0,    0,    0,    0,    0,    0,    0,    0,    0,    0,    0],
    [   0,    0,    0,    0,    0,    0,    0,    0,    0,    0,    0,  238,  115,  240,    0,    0,    0,    0,    0,    0],
    [ 328,  329,  330,    0,    0,    0,  129,    0,    0,    0,    0,    0,  239,    0,    0,    0,    0,    0,    0,  129],
    [ 358,  359,  360,    0,    0,    0,  159,    0,    0,    0,    0,    0,    0,    0,    0,    0,   23,   24,   25,  159],
    [   0,    0,    0,    0,    0,    0,  189,    0,    0,    0,    0,    0,    0,    0,    0,    0,   53,   54,   55,  189],
    [   0,    0,    0,    0,    0,    0,    0,    0,    0,    0,    0,    0,    0,    0,    0,    0,    0,    0,    0,    0]
  ]
}